PlayerID,PlayerName,PlayerShortName,Position,minutes,redcards,errors,pensconceded,owngoals,sumerrors
3158,Ryan Shawcross,Shawcross,Defender,27940,5,8,11,6,30
2651,Petr Cech,Cech,Goalkeeper,31609,1,24,3,2,30
3719,Heurelho Gomes,Gomes,Goalkeeper,17342,0,19,9,1,29
2537,Asmir Begovic,Begovic,Goalkeeper,22632,0,27,2,0,29
2932,Ben Foster,Foster,Goalkeeper,32395,0,20,9,0,29
3169,Tim Krul,Krul,Goalkeeper,19912,0,20,3,2,25
4664,Hugo Lloris,Lloris,Goalkeeper,30017,0,22,2,0,24
2516,Tim Howard,Howard,Goalkeeper,28508,1,15,7,1,24
4179,Simon Mignolet,Mignolet,Goalkeeper,21997,0,22,1,1,24
3309,Lukasz Fabianski,Fabianski,Goalkeeper,28188,1,18,4,0,23
1184,Richard Dunne,Dunne,Defender,16200,4,6,5,7,22
3143,Joe Hart,Hart,Goalkeeper,30399,0,19,3,0,22
3404,Martin Skrtel,Skrtel,Defender,20982,1,8,6,7,22
3222,Phil Jagielka,Jagielka,Defender,28013,3,7,6,5,21
2758,Robert Green,Green,Goalkeeper,18077,0,17,2,2,21
3681,Sebastien Bassong,Bassong,Defender,14537,3,7,9,1,20
4640,Jordan Pickford,Pickford,Goalkeeper,18943,0,16,3,0,19
12136,Granit Xhaka,Xhaka,Midfielder,15697,4,9,6,0,19
4100,David Luiz,Luiz,Defender,17836,4,5,9,1,19
3156,Jonny Evans,Evans,Defender,28856,3,6,4,6,19
3508,Younes Kaboul,Kaboul,Defender,16208,6,7,3,3,19
4666,Jan Vertonghen,Vertonghen,Defender,20131,1,10,5,2,18
2620,Gary Cahill,Cahill,Defender,31630,3,8,4,2,17
1353,John Terry,Terry,Defender,23901,5,6,3,3,17
3807,Scott Dann,Dann,Defender,20690,0,6,6,5,17
3909,Ben Mee,Mee,Defender,19346,0,6,6,5,17
3600,Séamus Coleman,Coleman,Defender,26360,2,5,5,5,17
3543,Wojciech Szczesny,Szczesny,Goalkeeper,11849,0,11,6,0,17
2949,Lee Cattermole,Cattermole,Midfielder,16807,7,7,3,0,17
4030,Laurent Koscielny,Koscielny,Defender,21419,5,2,8,2,17
2896,John Ruddy,Ruddy,Goalkeeper,10828,1,15,1,0,17
2574,Joleon Lescott,Lescott,Defender,21114,0,8,7,1,16
3562,Ciaran Clark,Clark,Defender,17636,3,3,9,1,16
1732,Gary Caldwell,Caldwell,Defender,8637,4,3,7,2,16
4330,David de Gea,Gea,Goalkeeper,33869,0,14,0,1,15
4606,José Fonte,Fonte,Defender,15526,1,4,10,0,15
1211,Wes Brown,Brown,Defender,11958,4,4,3,4,15
3558,Brad Guzan,Guzan,Goalkeeper,13757,0,11,4,0,15
4135,Jonjo Shelvey,Shelvey,Midfielder,19099,5,7,2,1,15
4852,Adrián,Adrian,Goalkeeper,12363,2,12,1,0,15
1218,Mark Schwarzer,Schwarzer,Goalkeeper,19440,0,15,0,0,15
2053,Robert Huth,Huth,Defender,23158,1,3,8,3,15
3517,James Tomkins,Tomkins,Defender,22797,2,7,5,0,14
3734,Jonas Olsson,Olsson,Defender,17080,1,6,3,4,14
1342,Jussi Jääskeläinen,Jaaskelainen,Goalkeeper,19143,1,8,4,1,14
4601,Artur Boruc,Boruc,Goalkeeper,11443,0,13,1,0,14
1404,Paul Robinson,Robinson,Goalkeeper,14966,0,12,2,0,14
2250,Scott Carson,Carson,Goalkeeper,9246,1,10,2,1,14
3955,Kyle Walker,Walker,Defender,28823,1,6,5,2,14
8045,Steve Cook,Cook,Defender,14598,1,6,4,3,14
2569,Wayne Hennessey,Hennessey,Goalkeeper,16370,0,13,0,1,14
2935,Nemanja Vidic,Vidic,Defender,15084,6,4,3,1,14
3799,Fabian Delph,Delph,Midfielder,14262,3,7,1,2,13
3653,Vincent Kompany,Kompany,Defender,22268,3,4,3,3,13
3613,Chris Smalling,Smalling,Defender,17116,1,4,4,4,13
2634,Ryan Nelsen,Nelsen,Defender,11806,3,2,7,1,13
8044,Simon Francis,Francis,Defender,11226,4,5,4,0,13
2002,Kolo Touré,Toure,Defender,14171,1,7,3,2,13
5672,Federico Fernández,Fernandez,Defender,17166,0,3,5,5,13
4437,Gareth McAuley,McAuley,Defender,17710,2,3,3,5,13
3654,Pablo Zabaleta,Zabaleta,Defender,24380,4,1,5,2,12
1751,Thomas Sørensen,Sorensen,Goalkeeper,8655,0,10,1,1,12
3506,Alan Hutton,Hutton,Defender,12023,3,3,3,3,12
2834,Vito Mannone,Mannone,Goalkeeper,7337,0,12,0,0,12
252,David James,James,Goalkeeper,8624,0,10,2,0,12
4403,Ashley Williams,Williams,Defender,21260,2,5,5,0,12
4198,Craig Dawson,Dawson,Defender,20384,2,1,6,3,12
2517,Phil Bardsley,Bardsley,Defender,22711,2,2,4,4,12
20559,Alisson,Alisson,Goalkeeper,12175,1,8,1,1,11
8163,Lewis Dunk,Dunk,Defender,15310,4,2,0,5,11
3471,Marc Wilson,Wilson,Midfielder,14175,2,5,3,1,11
2607,Manuel Almunia,Almunia,Goalkeeper,8808,0,8,3,0,11
2728,Nedum Onuoha,Onuoha,Defender,11323,1,2,5,3,11
2847,Craig Gardner,Gardner,Midfielder,15404,4,2,4,1,11
3014,Mark Noble,Noble,Midfielder,30867,5,4,1,1,11
3507,Danny Rose,Rose,Defender,15915,2,6,3,0,11
3680,Fabricio Coloccini,Coloccini,Defender,18638,4,3,2,2,11
9257,Jamaal Lascelles,Lascelles,Defender,12582,1,4,4,2,11
3956,Kyle Naughton,Naughton,Defender,14205,3,4,2,2,11
4112,Eric Dier,Dier,Defender,19869,0,6,4,1,11
915,Jamie Carragher,Carragher,Defender,15441,1,1,6,3,11
8900,Tyrone Mings,Mings,Defender,10148,1,4,2,3,10
2125,Sylvain Distin,Distin,Defender,22786,0,5,4,1,10
2100,James Milner,Milner,Midfielder,28956,3,3,3,1,10
12707,Ederson,Ederson,Goalkeeper,16257,1,6,3,0,10
4985,Bernd Leno,Leno,Goalkeeper,8977,1,8,0,1,10
2148,Glen Johnson,Johnson,Defender,23599,1,3,4,2,10
2075,Zat Knight,Knight,Defender,11795,1,5,3,1,10
4081,Charlie Adam,Adam,Midfielder,13212,4,4,0,2,10
4911,Thibaut Courtois,Courtois,Goalkeeper,11224,2,3,5,0,10
2867,Martin Olsson,Olsson,Defender,15934,2,4,3,1,10
2911,Pepe Reina,Reina,Goalkeeper,20603,1,6,2,1,10
1308,Gareth Barry,Barry,Midfielder,30091,3,3,3,1,10
3239,Benoit Assou-Ekotto,Assou-Ekotto,Defender,11736,2,4,4,0,10
19589,Jan Bednarek,Bednarek,Defender,11367,1,3,3,3,10
4505,John Stones,Stones,Defender,15443,1,8,1,0,10
4779,Maarten Stekelenburg,Stekelenburg,Goalkeeper,4896,0,9,0,1,10
3010,James Collins,Collins,Defender,20302,2,3,3,2,10
2413,Gaël Clichy,Clichy,Defender,22794,1,4,4,1,10
1890,Titus Bramble,Bramble,Defender,12419,1,4,3,2,10
1911,Damien Delaney,Delaney,Defender,10701,1,3,3,3,10
8966,Wes Morgan,Morgan,Defender,14328,3,2,3,2,10
4248,Carl Jenkinson,Jenkinson,Defender,6621,3,2,4,1,10
3160,Craig Cathcart,Cathcart,Defender,15061,0,5,0,4,9
6451,Martin Dúbravka,Dubravka,Goalkeeper,11430,0,9,0,0,9
20479,Wilfred Ndidi,Ndidi,Midfielder,14191,2,1,6,0,9
4333,Michael Keane,Keane,Defender,18658,1,3,2,3,9
5859,Luka Milivojevic,Milivojevic,Midfielder,13381,1,5,2,1,9
2805,Michael Dawson,Dawson,Defender,17378,1,5,2,1,9
9566,Harry Maguire,Maguire,Defender,17400,2,3,3,1,9
3170,Fraser Forster,Forster,Goalkeeper,11984,0,8,1,0,9
2991,Tom Huddlestone,Huddlestone,Midfielder,16095,5,1,2,1,9
20224,Davinson Sánchez,Sanchez,Defender,10021,1,2,4,2,9
3029,Paul Scharner,Scharner,Defender,13828,1,5,2,1,9
4496,César Azpilicueta,Azpilicueta,Defender,27855,2,1,3,3,9
26216,Çaglar Söyüncü,Soyuncu,Defender,7723,1,3,5,0,9
1420,Brad Friedel,Friedel,Goalkeeper,18154,1,7,1,0,9
2279,Stephen Warnock,Warnock,Defender,14012,0,5,3,1,9
1575,Steven Gerrard,Gerrard,Midfielder,19763,1,4,2,2,9
2508,Kasper Schmeichel,Schmeichel,Goalkeeper,25504,0,7,0,2,9
4804,Fernandinho,Fernandinho,Midfielder,20174,4,0,4,1,9
2609,Johan Djourou,Djourou,Defender,5454,1,3,4,1,9
4813,Dejan Lovren,Lovren,Defender,13163,0,7,2,0,9
4821,Erik Pieters,Pieters,Defender,18297,0,5,3,1,9
3624,Kamil Zayatte,Zayatte,Defender,4613,0,2,3,4,9
4610,Jos Hooiveld,Hooiveld,Defender,2303,0,2,2,4,8
3251,Adrian Mariappa,Mariappa,Defender,12022,1,4,2,1,8
3604,Marouane Fellaini,Fellaini,Midfielder,18688,3,1,4,0,8
4183,Ahmed El Mohamady,Mohamady,Defender,14375,1,2,4,1,8
8897,Aaron Cresswell,Cresswell,Defender,22143,1,6,1,0,8
4816,Victor Wanyama,Wanyama,Midfielder,10910,3,5,0,0,8
3806,Roger Johnson,Johnson,Defender,9423,0,2,3,3,8
4136,Conor Coady,Coady,Midfielder,13508,0,3,2,3,8
1131,Matt Upson,Upson,Defender,12641,0,2,4,2,8
4340,Paul Dummett,Dummett,Defender,11416,1,2,3,2,8
2393,Anton Ferdinand,Ferdinand,Defender,12480,0,3,2,3,8
3070,Christopher Samba,Samba,Defender,13668,3,0,4,1,8
10079,Nick Pope,Pope,Goalkeeper,12654,0,5,3,0,8
3820,Phil Jones,Jones,Defender,15866,0,1,5,2,8
2669,Emmerson Boyce,Boyce,Defender,13651,1,2,4,1,8
3561,Nathan Baker,Baker,Defender,6053,0,3,2,3,8
2890,Michael Essien,Essien,Midfielder,7931,2,3,2,1,8
2871,Ali Al Habsi,Habsi,Goalkeeper,9990,0,6,1,1,8
4651,Chico Flores,Flores,Defender,4931,3,2,2,1,8
11293,Serge Aurier,Aurier,Defender,6305,2,1,4,1,8
3512,Adam Smith,Smith,Defender,11410,1,1,5,1,8
2704,Mikel Arteta,Arteta,Midfielder,16739,3,1,2,2,8
4024,Mike Williamson,Williamson,Defender,11497,2,3,3,0,8
4605,Maya Yoshida,Yoshida,Defender,12386,1,6,1,0,8
5514,Angelo Ogbonna,Ogbonna,Defender,15036,0,2,5,1,8
4218,Antolín Alcaraz,Alcaraz,Defender,6916,2,3,2,1,8
3524,Maynor Figueroa,Figueroa,Defender,18433,1,4,3,0,8
5713,José Holebas,Holebas,Defender,9653,1,3,4,0,8
2129,Chris Baird,Baird,Defender,10154,1,0,3,4,8
2738,Paul McShane,McShane,Defender,7965,1,3,1,2,7
4084,Jason David Ian Puncheon,Puncheon,Midfielder,14749,1,6,0,0,7
4351,Ryan Bennett,Bennett,Defender,8967,0,2,3,2,7
3979,James McCarthy,McCarthy,Midfielder,20913,1,1,4,1,7
3009,Danny Gabbidon,Gabbidon,Defender,7060,0,2,3,2,7
13274,Ezri Konsa,Konsa,Defender,7718,2,2,3,0,7
2435,Steven Reid,Reid,Defender,7714,0,2,4,1,7
2013,Liam Ridgewell,Ridgewell,Defender,15548,1,4,1,1,7
2011,Boaz Myhill,Myhill,Goalkeeper,10564,0,6,1,0,7
2749,David Wheater,Wheater,Defender,8336,3,1,2,1,7
12937,Eric Bailly,Bailly,Defender,4979,1,1,3,2,7
2611,Mathieu Flamini,Flamini,Midfielder,7082,1,5,0,1,7
19605,Christian Kabasele,Kabasele,Defender,8128,3,0,3,1,7
10968,Ben Godfrey,Godfrey,Defender,7360,1,2,2,2,7
11347,Cédric Soares,Soares,Defender,12570,0,6,1,0,7
851,Shay Given,Given,Goalkeeper,12048,0,5,0,2,7
4726,David Marshall,Marshall,Goalkeeper,4770,0,6,0,1,7
3920,Paul Pogba,Pogba,Midfielder,12290,2,1,4,0,7
3739,Leon Barnett,Barnett,Defender,2701,1,3,2,1,7
1230,Aaron Hughes,Hughes,Defender,17250,0,5,0,2,7
4600,Paulo Gazzaniga,Gazzaniga,Goalkeeper,3804,0,6,1,0,7
49884,Issa Diop,Diop,Defender,8077,0,2,3,2,7
4608,Luke Shaw,Shaw,Defender,16581,1,2,3,1,7
5140,Virgil van Dijk,Dijk,Defender,17403,1,3,3,0,7
4617,James Ward-Prowse,Ward-Prowse,Midfielder,20690,2,1,3,1,7
1359,Chris Kirkland,Kirkland,Goalkeeper,9230,0,6,1,0,7
4835,Jordi Amat,Amat,Defender,3703,0,5,2,0,7
6058,Nicolás Otamendi,Otamendi,Defender,11177,0,5,1,1,7
3623,Sam Ricketts,Ricketts,Defender,7878,2,0,3,2,7
1515,Paul Konchesky,Konchesky,Defender,12115,3,2,2,0,7
3644,Martin Kelly,Kelly,Defender,11808,0,5,0,2,7
3702,Andy Wilkinson,Wilkinson,Defender,9076,2,2,2,1,7
4721,Leandro Bacuna,Bacuna,Midfielder,6547,0,5,2,0,7
1494,Ashley Cole,Cole,Defender,17860,2,3,2,0,7
4796,Mamadou Sakho,Sakho,Defender,10663,1,3,3,0,7
3796,Thomas Vermaelen,Vermaelen,Defender,8746,1,2,2,2,7
5668,Miguel Britos,Britos,Defender,5342,3,3,1,0,7
1694,Ian Evatt,Evatt,Defender,3215,1,2,2,2,7
4766,Mile Jedinak,Jedinak,Midfielder,7089,1,3,3,0,7
3861,Nemanja Matic,Matic,Midfielder,19270,3,1,3,0,7
3193,Ibrahima Sonko,Sonko,Defender,2761,1,0,6,0,7
4573,Alex McCarthy,McCarthy,Goalkeeper,12656,0,7,0,0,7
8143,James Tarkowski,Tarkowski,Defender,16200,0,4,2,1,7
3821,Steven Nzonzi,Nzonzi,Midfielder,16469,3,1,3,0,7
4546,Mathieu Debuchy,Debuchy,Defender,4630,2,1,3,1,7
20745,Romain Saïss,Saiss,Midfielder,8966,1,2,4,0,7
3280,John Pantsil,Pantsil,Defender,7209,0,3,0,4,7
3157,Danny Simpson,Simpson,Defender,17808,1,2,4,0,7
4916,Toby Alderweireld,Alderweireld,Defender,17579,0,1,2,3,6
2933,Tom Heaton,Heaton,Goalkeeper,10381,0,3,1,2,6
4158,Robbie Brady,Brady,Midfielder,9846,1,3,2,0,6
2518,Jonathan Spector,Spector,Defender,4946,0,3,2,1,6
2976,Danny Collins,Collins,Defender,10542,0,1,3,2,6
3137,Lucas Leiva,Leiva,Midfielder,17328,1,2,2,1,6
3136,Javier Mascherano,Mascherano,Defender,7305,3,2,1,0,6
3563,Carlos Cuellar,Cuellar,Defender,10360,1,2,1,2,6
2485,Richard Stearman,Stearman,Defender,6027,1,2,2,1,6
9595,Michail Antonio,Antonio,Forward,14686,2,2,2,0,6
3082,Abdoulaye Méité,Meite,Defender,4101,0,4,1,1,6
2323,Steven Taylor,Taylor,Defender,11505,2,0,3,1,6
2309,Ross Turnbull,Turnbull,Goalkeeper,2835,0,5,0,1,6
15715,José Sá,Sa,Goalkeeper,3285,0,2,3,1,6
4785,Allan McGregor,McGregor,Goalkeeper,4567,2,2,2,0,6
3569,Gaël Givet,Givet,Defender,8126,2,1,2,1,6
7548,Vicente Guaita,Guaita,Goalkeeper,10890,0,3,2,1,6
4620,Calum Chambers,Chambers,Defender,12086,1,1,3,1,6
2925,Micah Richards,Richards,Defender,12872,0,1,4,1,6
3349,Grétar Steinsson,Steinsson,Defender,10765,1,1,3,1,6
3360,Branislav Ivanovic,Ivanovic,Defender,22257,2,2,2,0,6
3991,Ronald Zubar,Zubar,Defender,4482,1,1,2,2,6
4319,Costel Pantilimon,Pantilimon,Goalkeeper,4761,0,4,1,1,6
12444,Jonas Lössl,Lossl,Goalkeeper,6377,0,5,0,1,6
5758,Lucas Digne,Digne,Defender,11125,2,0,1,3,6
3989,Christophe Berra,Berra,Defender,8323,1,3,2,0,6
10458,Andrew Robertson,Robertson,Defender,18463,1,2,3,0,6
3348,Ádám Bogdán,Bogdan,Goalkeeper,2301,0,5,1,0,6
5334,Eliaquim Mangala,Mangala,Defender,4817,1,2,1,2,6
3488,Craig Gordon,Gordon,Goalkeeper,7897,0,5,0,1,6
4252,Alex Oxlade-Chamberlain,Oxlade-Chamberlain,Midfielder,10381,0,4,1,1,6
2217,Michael Turner,Turner,Defender,13917,2,1,3,0,6
5272,Pierre-Emile Højbjerg,Hojbjerg,Midfielder,15102,2,2,2,0,6
5175,Kurt Zouma,Zouma,Defender,14758,1,2,1,2,6
4246,Per Mertesacker,Mertesacker,Defender,13609,2,3,1,0,6
4612,Jack Stephens,Stephens,Defender,9948,2,1,3,0,6
4477,Santi Cazorla,Cazorla,Midfielder,10808,1,4,1,0,6
1505,Jlloyd Samuel,Samuel,Defender,5661,1,1,2,2,6
2058,Carlton Cole,Cole,Forward,11646,3,1,1,1,6
2007,Steve Sidwell,Sidwell,Midfielder,10677,2,3,1,0,6
1717,John O'Shea,O'Shea,Defender,21571,1,0,3,2,6
557,Sol Campbell,Campbell,Defender,6986,0,3,1,2,6
2047,Jonathan Walters,Walters,Forward,16706,1,1,2,2,6
921,Phil Neville,Neville,Midfielder,14710,1,1,2,2,6
26151,Joachim Andersen,Andersen,Defender,5645,1,2,2,1,6
2054,William Gallas,Gallas,Defender,12324,0,3,2,1,6
9117,Ben Gibson,Gibson,Defender,5978,1,1,3,0,5
1391,Rory Delap,Delap,Midfielder,10241,1,1,2,1,5
3186,Nicky Shorey,Shorey,Defender,11663,0,3,1,1,5
3030,Leighton Baines,Baines,Defender,29200,0,1,2,2,5
4349,Russell Martin,Martin,Defender,10853,1,2,1,1,5
3751,Youssouf Mulumbu,Mulumbu,Midfielder,12791,4,0,1,0,5
4797,Aly Cissokho,Cissokho,Defender,4823,1,0,3,1,5
3744,Chris Brunt,Brunt,Midfielder,21216,0,2,3,0,5
2584,Keith Andrews,Andrews,Midfielder,5506,0,1,4,0,5
3175,Andy Carroll,Carroll,Forward,13827,2,2,1,0,5
4341,Yohan Cabaye,Cabaye,Midfielder,13691,0,4,1,0,5
9960,Alfie Mawson,Mawson,Defender,6980,0,2,1,2,5
4487,Matthew Lowton,Lowton,Defender,19328,1,2,2,0,5
13823,Abdoulaye Doucouré,Doucoure,Midfielder,15902,0,1,2,2,5
1943,Darren Fletcher,Fletcher,Midfielder,19531,1,3,1,0,5
3664,Rafael,Rafael,Defender,8182,2,0,3,0,5
1982,Kieran Richardson,Richardson,Defender,15915,2,2,1,0,5
1881,Tony Hibbert,Hibbert,Defender,9737,1,0,2,2,5
4696,Joel Robles,Robles,Goalkeeper,4457,0,4,1,0,5
3154,Daniel Sturridge,Sturridge,Forward,11333,1,2,2,0,5
3712,Jordan Henderson,Henderson,Midfielder,30144,2,2,1,0,5
1426,Danny Higginbotham,Higginbotham,Defender,7401,0,1,3,1,5
1361,George Boateng,Boateng,Midfielder,6523,2,2,1,0,5
3394,Brede Hangeland,Hangeland,Defender,20992,1,1,1,2,5
2997,Curtis Davies,Davies,Defender,11548,0,3,1,1,5
4615,Morgan Schneiderlin,Schneiderlin,Midfielder,15402,3,1,1,0,5
4474,Héctor Bellerín,Bellerin,Defender,15136,0,1,3,1,5
4489,Ashley Westwood,Westwood,Midfielder,23743,0,2,2,1,5
3869,Shkodran Mustafi,Mustafi,Defender,8414,0,3,2,0,5
2837,Alexandre Song,Song,Midfielder,13267,1,0,3,1,5
1111,Rio Ferdinand,Ferdinand,Defender,14991,0,2,3,0,5
2845,Emmanuel Adebayor,Adebayor,Forward,14938,2,2,0,1,5
51775,Mohammed Salisu,Salisu,Defender,3814,1,2,1,1,5
11341,Rui Patrício,Patricio,Goalkeeper,10078,0,5,0,0,5
2070,Edwin van der Sar,Sar,Goalkeeper,10338,0,5,0,0,5
2064,Wayne Rooney,Rooney,Forward,25810,2,1,1,1,5
2886,Ryan Bertrand,Bertrand,Defender,22728,2,1,2,0,5
3929,Joel Ward,Ward,Defender,22116,0,3,1,1,5
3833,Brian Jensen,Jensen,Goalkeeper,3345,0,3,2,0,5
4549,Moussa Sissoko,Sissoko,Midfielder,22242,2,1,2,0,5
2916,Daniel Agger,Agger,Defender,11531,1,1,2,1,5
2681,Wayne Routledge,Routledge,Midfielder,14148,1,1,3,0,5
2018,Lucas Neill,Neill,Defender,6993,0,0,4,1,5
2664,Julian Speroni,Speroni,Goalkeeper,7795,0,5,0,0,5
4560,Alexander Tettey,Tettey,Midfielder,7692,0,4,1,0,5
50234,Gabriel Magalhães,Magalhaes,Defender,5065,2,2,1,0,5
10564,Mason Holgate,Holgate,Defender,9437,1,3,0,1,5
2980,Dean Whitehead,Whitehead,Midfielder,14814,2,2,1,0,5
1518,Scott Parker,Parker,Midfielder,15286,2,2,1,0,5
10522,DeAndre Yedlin,Yedlin,Defender,8512,1,0,2,2,5
4486,Ron Vlaar,Vlaar,Defender,6842,1,1,2,1,5
5001,Emre Can,Can,Midfielder,9019,1,3,1,0,5
3610,David Stockdale,Stockdale,Goalkeeper,3358,0,4,0,1,5
3327,Chris Herd,Herd,Midfielder,2509,1,2,2,0,5
3567,Mark Bunn,Bunn,Goalkeeper,3249,1,1,1,2,5
3388,Steven Pienaar,Pienaar,Midfielder,16414,4,0,1,0,5
3587,José Bosingwa,Bosingwa,Defender,8776,1,0,2,2,5
66378,Illan Meslier,Meslier,Goalkeeper,6535,0,3,1,1,5
25309,Juan Foyth,Foyth,Defender,956,1,2,2,0,5
4843,Etienne Capoue,Capoue,Midfielder,14740,1,1,3,0,5
1780,Paul Robinson,Robinson,Defender,9786,1,1,3,0,5
4841,Paulinho,Paulinho,Midfielder,2860,1,4,0,0,5
7500,Sol Bamba,Bamba,Defender,2475,0,3,2,0,5
3244,Jake Livermore,Livermore,Midfielder,14236,2,0,2,1,5
24626,Douglas Luiz,Luiz,Midfielder,8117,1,1,3,0,5
5220,Fabian Schär,Schar,Defender,7043,1,3,1,0,5
3242,Charlie Daniels,Daniels,Defender,11061,0,3,2,0,5
776,Stephen Carr,Carr,Defender,7183,0,2,2,1,5
3362,Patrick van Aanholt,Aanholt,Defender,17744,0,2,1,2,5
2216,Darren Randolph,Randolph,Goalkeeper,2970,0,5,0,0,5
3465,Habib Beye,Beye,Defender,4994,2,0,2,1,5
5066,Victor Lindelöf,Lindelof,Defender,11920,0,2,1,2,5
6194,Wesley Hoedt,Hoedt,Defender,3690,0,2,1,2,5
2259,Clarke Carlisle,Carlisle,Defender,2374,0,2,2,1,5
2040,Kevin Nolan,Nolan,Midfielder,15487,3,0,1,0,4
4550,Vurnon Anita,Anita,Midfielder,7569,0,1,3,0,4
3527,Wilson Palacios,Palacios,Midfielder,9641,2,0,2,0,4
3819,Grant Hanley,Hanley,Defender,6515,0,1,1,2,4
3513,Gareth Bale,Bale,Forward,12830,1,1,1,1,4
2936,James Chester,Chester,Defender,4702,1,0,1,2,4
3811,Nathan Redmond,Redmond,Midfielder,18955,1,1,2,0,4
2934,Patrice Evra,Evra,Defender,20894,0,1,2,1,4
25183,Tomas Soucek,Soucek,Midfielder,7522,1,0,1,2,4
1664,Andy O'Brien,O'Brien,Defender,6146,0,2,2,0,4
3390,Dan Gosling,Gosling,Midfielder,10466,1,2,1,0,4
6519,Sadio Mané,Mane,Forward,20657,3,0,1,0,4
4815,Matt Targett,Targett,Defender,11595,0,1,2,1,4
11259,João Moutinho,Moutinho,Midfielder,11653,1,0,3,0,4
5721,Gaëtan Bong,Bong,Defender,4100,0,1,2,1,4
2798,Marton Fülöp,Fulop,Goalkeeper,3893,0,4,0,0,4
4492,Christian Benteke,Benteke,Forward,19246,4,0,0,0,4
12192,Mathew Ryan,Ryan,Goalkeeper,11160,0,2,2,0,4
4495,Andreas Christensen,Christensen,Defender,7314,1,3,0,0,4
5682,Jorginho,Jorginho,Midfielder,9841,0,2,2,0,4
11575,Rob Holding,Holding,Defender,6416,1,0,2,1,4
1677,Mario Melchiot,Melchiot,Defender,8413,1,1,2,0,4
2239,Joseph Yobo,Yobo,Defender,6832,0,2,1,1,4
5861,Cheikhou Kouyaté,Kouyate,Midfielder,20732,1,1,2,0,4
11284,Arthur Masuaku,Masuaku,Defender,7185,1,1,2,0,4
5865,Youri Tielemans,Tielemans,Midfielder,9916,0,0,4,0,4
5866,Leander Dendoncker,Dendoncker,Midfielder,8709,0,1,1,2,4
2887,Michael Mancienne,Mancienne,Defender,3282,0,2,1,1,4
5879,Aleksandar Mitrovic,Mitrovic,Forward,6873,2,0,2,0,4
2889,Jack Cork,Cork,Midfielder,23894,0,1,0,3,4
7213,Sergio Rico,Rico,Goalkeeper,2610,0,3,1,0,4
4577,Sean Morrison,Morrison,Defender,4367,0,1,3,0,4
1565,Jonathan Woodgate,Woodgate,Defender,6853,0,1,2,1,4
3601,Shane Duffy,Duffy,Defender,9261,1,1,2,0,4
1412,Alan Smith,Smith,Midfielder,3370,1,2,1,0,4
4714,Mesut Özil,Ozil,Midfielder,15255,0,4,0,0,4
9426,Adam Webster,Webster,Defender,6696,0,1,2,1,4
4840,Vlad Chiriches,Chiriches,Defender,2121,1,3,0,0,4
32923,Yerry Mina,Mina,Defender,5959,0,3,0,1,4
1887,Leon Osman,Osman,Midfielder,18251,0,3,0,1,4
4781,Fernando Amorebieta,Amorebieta,Defender,1846,1,0,2,1,4
1249,Kevin Davies,Davies,Forward,14590,0,0,2,2,4
8979,Jamie Vardy,Vardy,Forward,21858,3,0,0,1,4
1464,Luke Young,Young,Defender,11512,0,1,2,1,4
3240,Ricardo Rocha,Rocha,Defender,1147,2,0,1,1,4
26408,Emiliano Buendía,Buendia,Midfielder,4363,1,2,1,0,4
8246,Ashley Barnes,Barnes,Forward,12239,2,0,1,1,4
32435,Fabián Balbuena,Balbuena,Defender,4388,1,2,1,0,4
4810,Leroy Fer,Fer,Midfielder,9389,1,2,1,0,4
4847,Nabil Bentaleb,Bentaleb,Midfielder,4180,0,4,0,0,4
9947,Troy Deeney,Deeney,Forward,12877,2,0,0,2,4
3285,Antonio Valencia,Valencia,Defender,24147,2,2,0,0,4
4673,Claudio Yacob,Yacob,Midfielder,11887,1,1,2,0,4
2974,Nyron Nosworthy,Nosworthy,Defender,4635,0,0,4,0,4
3547,Jack Wilshere,Wilshere,Midfielder,11772,2,2,0,0,4
4823,Marko Arnautovic,Arnautovic,Forward,14034,2,0,2,0,4
4604,Nathaniel Clyne,Clyne,Defender,18248,0,3,0,1,4
7219,Alberto Moreno,Moreno,Defender,6526,0,2,2,0,4
7749,Juan Cala,Cala,Defender,585,1,2,1,0,4
3015,Nigel Reo-Coker,Reo-Coker,Midfielder,10766,1,0,2,1,4
1627,Ledley King,King,Defender,6244,0,3,1,0,4
3027,Ryan Taylor,Taylor,Defender,6107,1,2,1,0,4
1974,Stephen Kelly,Kelly,Defender,8556,0,2,2,0,4
3564,Marc Albrighton,Albrighton,Midfielder,18863,1,0,3,0,4
3329,Richard Kingson,Kingson,Goalkeeper,2138,0,4,0,0,4
10472,Marcos Rojo,Rojo,Defender,5649,0,1,2,1,4
4636,Geoff Cameron,Cameron,Midfielder,13568,1,0,3,0,4
8050,Harry Arter,Arter,Midfielder,7596,1,3,0,0,4
9251,Karl Darlow,Darlow,Goalkeeper,4680,0,2,1,1,4
10633,Bruno Ecuele Manga,Manga,Defender,3375,0,2,2,0,4
13822,Sebastian Prödl,Prodl,Defender,6185,1,2,1,0,4
15011,Yan Valery,Valery,Defender,2966,1,3,0,0,4
2299,Glenn Whelan,Whelan,Midfielder,20834,1,0,2,1,4
2303,Joey Barton,Barton,Midfielder,11466,4,0,0,0,4
336,Paul Scholes,Scholes,Midfielder,8525,2,1,1,0,4
4093,Marcos Alonso,Alonso,Defender,15009,1,1,2,0,4
13821,Allan-Roméo Nyom,Nyom,Defender,7419,0,1,3,0,4
4405,Angel Rangel,Rangel,Defender,13090,1,1,2,0,4
2412,Philippe Senderos,Senderos,Defender,6775,1,0,2,1,4
15202,Declan Rice,Rice,Midfielder,13905,0,2,2,0,4
2711,Papa Bouba Diop,Diop,Midfielder,4221,0,0,4,0,4
4209,Winston Reid,Reid,Defender,13903,1,0,1,2,4
4290,Romelu Lukaku,Lukaku,Forward,20663,0,3,0,1,4
19600,Loris Karius,Karius,Goalkeeper,2610,0,2,2,0,4
4353,Bradley Johnson,Johnson,Midfielder,7945,1,2,0,1,4
4193,Sandro,Sandro,Midfielder,6695,0,3,0,1,4
2341,Nathan Dyer,Dyer,Midfielder,10054,2,0,2,0,4
16801,Antonio Rüdiger,Rudiger,Defender,11665,0,2,0,2,4
2120,Franck Queudrue,Queudrue,Defender,1711,1,2,1,0,4
19607,Christopher Schindler,Schindler,Defender,6528,2,1,1,0,4
13344,Matthew Cash,Cash,Defender,5758,1,0,3,0,4
16790,Davy Pröpper,Propper,Midfielder,8711,1,2,1,0,4
4398,Michel Vorm,Vorm,Goalkeeper,9112,1,3,0,0,4
16642,Nélson Semedo,Semedo,Defender,5125,0,1,2,1,4
3934,Matt Ritchie,Ritchie,Midfielder,12809,0,1,2,1,4
2613,Sebastian Larsson,Larsson,Midfielder,20886,1,0,3,0,4
4413,Joe Allen,Allen,Midfielder,14528,1,2,1,0,4
16607,Florian Lejeune,Lejeune,Defender,3600,0,2,2,0,4
14164,Aaron Wan-Bissaka,Wan-Bissaka,Defender,11689,1,0,3,0,4
2755,Charles N'Zogbia,N'Zogbia,Midfielder,15216,1,1,2,0,4
14571,Reece James,James,Defender,5745,1,0,2,1,4
4141,Aleksandar Kolarov,Kolarov,Defender,11856,1,2,0,1,4
4472,Nacho Monreal,Monreal,Defender,15055,0,1,3,0,4
1004,Damien Duff,Duff,Midfielder,13102,0,2,1,1,4
54889,Édouard Mendy,Mendy,Goalkeeper,5805,0,2,2,0,4
2423,Steven Davis,Davis,Midfielder,15938,0,2,1,1,4
3997,Karl Henry,Henry,Midfielder,10547,3,1,0,0,4
4229,Matt Doherty,Doherty,Defender,8144,1,0,2,1,4
16204,Willy Boly,Boly,Defender,7927,2,0,2,0,4
3999,Stephen Ward,Ward,Defender,13938,1,1,2,0,4
4172,Cheick Tioté,Tiote,Midfielder,11002,1,1,2,0,4
4481,Olivier Giroud,Giroud,Forward,14452,2,1,0,1,4
4316,Raheem Sterling,Sterling,Forward,24173,1,0,3,0,4
4394,John Egan,Egan,Defender,5819,2,1,1,0,4
13703,Aaron Ramsdale,Ramsdale,Goalkeeper,9810,0,3,1,0,4
13988,Dean Henderson,Henderson,Goalkeeper,4365,0,3,0,0,3
8878,Tommy Smith,Smith,Defender,3050,1,1,1,0,3
8245,Danny Ings,Ings,Forward,12205,0,2,1,0,3
4258,Enda Stevens,Stevens,Defender,6516,0,2,1,0,3
3210,Paddy Kenny,Kenny,Goalkeeper,2970,0,2,1,0,3
3618,Matt Duke,Duke,Goalkeeper,1890,0,2,1,0,3
8586,Jeff Hendrick,Hendrick,Midfielder,10533,2,0,1,0,3
8589,Will Hughes,Hughes,Midfielder,6746,0,0,3,0,3
4827,Valentin Roberge,Roberge,Defender,758,0,2,1,0,3
800,Frank Lampard,Lampard,Midfielder,17303,1,2,0,0,3
4287,Juan Mata,Mata,Midfielder,18889,1,1,0,1,3
12582,Idrissa Gueye,Gueye,Midfielder,11342,1,1,1,0,3
3647,Jay Spearing,Spearing,Midfielder,2174,1,1,1,0,3
3183,Ben Hamer,Hamer,Goalkeeper,1547,0,3,0,0,3
3102,John Obi Mikel,Mikel,Midfielder,15286,1,2,0,0,3
918,Michael Brown,Brown,Midfielder,6081,1,0,2,0,3
3713,Jack Colback,Colback,Midfielder,14023,1,1,0,1,3
3995,Scott Malone,Malone,Defender,1115,0,2,1,0,3
4717,Alexander Iwobi,Iwobi,Forward,11086,0,2,1,0,3
3703,Ryan Shotton,Shotton,Defender,3264,1,1,1,0,3
33061,Kenny McLean,McLean,Midfielder,5670,0,1,2,0,3
4720,Antonio Luna,Luna,Defender,1381,0,2,0,1,3
2542,Matthew Taylor,Taylor,Midfielder,12544,0,2,1,0,3
3695,Nadir Belhadj,Belhadj,Defender,3392,1,1,1,0,3
4748,Willian,Willian,Forward,16368,1,2,0,0,3
3670,Danny Drinkwater,Drinkwater,Midfielder,7837,1,2,0,0,3
1458,Wayne Bridge,Bridge,Defender,6198,0,2,1,0,3
3666,Ritchie De Laet,Laet,Defender,3247,0,2,1,0,3
4306,Pavel Pogrebnyak,Pogrebnyak,Forward,2985,1,0,2,0,3
8980,Jeffrey Schlupp,Schlupp,Midfielder,12776,0,1,1,1,3
4245,Emiliano Martínez,Martinez,Goalkeeper,7911,0,2,1,0,3
3172,David Edgar,Edgar,Defender,1024,1,0,2,0,3
4802,Martín Demichelis,Demichelis,Defender,6004,0,1,1,1,3
709,Steve Harper,Harper,Goalkeeper,7207,0,1,2,0,3
4909,Roberto Jiménez,Jimenez,Goalkeeper,686,0,2,0,1,3
14538,Robert Sánchez,Sanchez,Goalkeeper,5759,1,1,1,0,3
5850,Chancel Mbemba,Mbemba,Defender,3596,0,2,1,0,3
15269,Angus Gunn,Gunn,Goalkeeper,2790,0,3,0,0,3
24659,Nathan Collins,Collins,Defender,1669,1,0,2,0,3
6047,Joe Ledley,Ledley,Midfielder,5962,0,3,0,0,3
6030,Salomón Rondón,Rondon,Forward,11621,2,1,0,0,3
5906,Fred,Fred,Midfielder,7631,0,1,1,1,3
1756,George McCartney,McCartney,Defender,9074,1,0,1,1,3
2296,Sun Jihai,Jihai,Defender,803,0,0,2,1,3
335,Ryan Giggs,Giggs,Midfielder,10355,0,3,0,0,3
3420,Fernando Torres,Torres,Forward,14693,3,0,0,0,3
1754,Jody Craddock,Craddock,Defender,4220,0,1,1,1,3
332,Nicky Butt,Butt,Midfielder,5886,1,0,2,0,3
14548,Benjamin White,White,Defender,6074,1,0,1,1,3
4152,Mario Balotelli,Balotelli,Forward,3940,3,0,0,0,3
24630,Richarlison,Richarlison,Forward,13979,2,0,1,0,3
4115,Ross Barkley,Barkley,Midfielder,14888,0,2,1,0,3
3480,Kalifa Cissé,Cisse,Defender,1116,1,1,1,0,3
5371,Christian Fuchs,Fuchs,Defender,9408,0,1,1,1,3
5595,Jordan Ayew,Ayew,Forward,14538,2,1,0,0,3
3447,Nani,Nani,Midfielder,9714,2,1,0,0,3
3448,Tom Cleverley,Cleverley,Midfielder,16133,1,2,0,0,3
5375,Joel Matip,Matip,Defender,10171,0,2,1,0,3
5575,Benjamin Mendy,Mendy,Defender,3791,0,2,1,0,3
3518,Julien Faubert,Faubert,Defender,5151,0,0,2,1,3
16431,Rúben Dias,Dias,Defender,5248,0,0,2,1,3
4185,Stéphane Sessegnon,Sessegnon,Midfielder,12812,2,0,1,0,3
7103,Zanka,Zanka,Defender,6085,0,1,2,0,3
26220,Robin Koch,Koch,Defender,2705,0,1,2,0,3
4842,Erik Lamela,Lamela,Midfielder,9319,1,0,2,0,3
2425,Colin Doyle,Doyle,Goalkeeper,319,0,2,1,0,3
22866,Juraj Kucka,Kucka,Midfielder,1923,1,0,1,1,3
3311,Bacary Sagna,Sagna,Defender,22665,1,1,1,0,3
3312,Kyle Bartley,Bartley,Defender,3970,0,2,1,0,3
3314,Luke Ayling,Ayling,Defender,5675,1,0,2,0,3
9793,Santiago Vergini,Vergini,Defender,3601,0,2,0,1,3
3581,Chris Basham,Basham,Defender,6657,0,1,2,0,3
2417,Cesc Fàbregas,Fabregas,Midfielder,18434,2,1,0,0,3
14732,Trent Alexander-Arnold,Alexander-Arnold,Defender,13268,0,2,1,0,3
1629,Peter Crouch,Crouch,Forward,21292,0,1,0,2,3
7934,Tyler Blackett,Blackett,Defender,650,1,0,1,1,3
4199,Gabriel Tamas,Tamas,Defender,3331,1,0,1,1,3
7336,Vladimir Coufal,Coufal,Defender,5266,1,0,1,1,3
14897,Sean Longstaff,Longstaff,Midfielder,4927,1,2,0,0,3
7215,Federico Fazio,Fazio,Defender,1777,1,1,1,0,3
3548,Aaron Ramsey,Ramsey,Midfielder,16707,0,1,1,1,3
1771,Anthony Gardner,Gardner,Defender,3054,0,2,0,1,3
2359,Dean Marney,Marney,Midfielder,7076,1,1,1,0,3
3363,Florent Malouda,Malouda,Midfielder,9687,1,2,0,0,3
3724,Andros Townsend,Townsend,Midfielder,17853,0,2,1,0,3
3462,José Enrique,Enrique,Defender,12769,0,2,1,0,3
50245,Yves Bissouma,Bissouma,Midfielder,8255,1,1,1,0,3
3765,Valon Behrami,Behrami,Midfielder,7892,1,1,1,0,3
13193,Jack Simpson,Simpson,Defender,713,0,1,1,1,3
2112,Roy Carroll,Carroll,Goalkeeper,1260,0,3,0,0,3
1306,Luís Boa Morte,Morte,Midfielder,4282,1,0,2,0,3
20109,Jannik Vestergaard,Vestergaard,Defender,6666,1,1,1,0,3
10491,Darnell Furlong,Furlong,Defender,3157,0,0,2,1,3
3960,Harry Kane,Kane,Forward,23533,0,0,0,3,3
4514,Sascha Riether,Riether,Defender,5690,0,0,2,1,3
13491,Ben Chilwell,Chilwell,Defender,10994,1,1,1,0,3
4371,Clint Hill,Hill,Defender,5740,1,0,1,1,3
2840,Abou Diaby,Diaby,Midfielder,6287,2,0,0,1,3
4616,Gastón Ramírez,Ramirez,Midfielder,4785,3,0,0,0,3
10480,Daryl Janmaat,Janmaat,Defender,11576,2,0,0,1,3
2839,Theo Walcott,Walcott,Forward,21629,0,1,2,0,3
3905,Kieran Trippier,Trippier,Defender,9060,0,2,0,1,3
4634,Jack Butland,Butland,Goalkeeper,7740,0,1,1,1,3
3752,Romaine Sawyers,Sawyers,Midfielder,1490,0,2,0,1,3
2008,Jerome Thomas,Thomas,Midfielder,5431,0,0,3,0,3
3948,John Mensah,Mensah,Defender,2267,1,0,1,1,3
19608,Chris Löwe,Lowe,Defender,3650,0,1,2,0,3
11260,Tiemoué Bakayoko,Bakayoko,Midfielder,2124,1,2,0,0,3
11044,Aymeric Laporte,Laporte,Defender,9145,1,1,1,0,3
19620,Oleksandr Zinchenko,Zinchenko,Midfielder,5477,1,2,0,0,3
2122,Stewart Downing,Downing,Midfielder,24844,0,2,0,1,3
4558,Robert Snodgrass,Snodgrass,Midfielder,12491,0,0,3,0,3
2655,Alex,Alex,Defender,6660,0,3,0,0,3
3837,Kevin Long,Long,Defender,3849,0,1,1,1,3
13387,Ramiro Mori,Mori,Defender,3849,1,0,2,0,3
3818,Míchel Salgado,Salgado,Defender,5122,0,0,3,0,3
4402,Neil Taylor,Taylor,Defender,11925,0,0,2,1,3
2653,Ricardo Carvalho,Carvalho,Defender,4567,1,1,1,0,3
2647,Joseph O'Brien,O'Brien,Defender,6170,0,1,1,1,3
3801,Jonathan Hogg,Hogg,Midfielder,5176,2,1,0,0,3
4544,Mapou Yanga-Mbiwa,Yanga-Mbiwa,Defender,2534,1,0,2,0,3
50165,Ozan Kabak,Kabak,Defender,1727,0,1,2,0,3
10651,Joseph Gomez,Gomez,Defender,6318,0,0,3,0,3
2645,Tal Ben Haim,Haim,Defender,5037,0,1,2,0,3
4438,Billy Jones,Jones,Defender,11114,0,1,1,1,3
11373,Kepa Arrizabalaga,Arrizabalaga,Goalkeeper,7155,0,3,0,0,3
13492,N'Golo Kanté,Kante,Midfielder,17908,0,2,1,0,3
3887,Kagisho Dikgacoi,Dikgacoi,Midfielder,2546,2,0,1,0,3
3975,Steve Gohouri,Gohouri,Defender,3411,1,2,0,0,3
19731,Ethan Ampadu,Ampadu,Defender,2100,0,1,1,1,3
10430,Carlos Sánchez,Sanchez,Midfielder,3708,1,2,0,0,3
10428,Ainsley Maitland-Niles,Maitland-Niles,Midfielder,5262,2,0,1,0,3
10424,Semi Ajayi,Ajayi,Defender,2780,1,0,2,0,3
12199,Björn Engels,Engels,Defender,1447,0,1,2,0,3
3062,Ashley Young,Young,Defender,27910,2,0,0,1,3
10423,Gabriel Paulista,Paulista,Defender,3626,1,1,1,0,3
12359,Terence Kongolo,Kongolo,Defender,3858,0,1,1,1,3
2080,Sean Davis,Davis,Midfielder,4594,2,0,1,0,3
33124,Pascal Struijk,Struijk,Defender,4127,1,1,1,0,3
3900,Sotirios Kyrgiakos,Kyrgiakos,Defender,2462,1,1,1,0,3
4680,Guy Demel,Demel,Defender,5374,0,2,0,1,3
19970,Max Aarons,Aarons,Defender,6122,0,0,2,1,3
13561,Timothy Fosu-Mensah,Fosu-Mensah,Defender,2955,0,1,1,1,3
3052,Tomas Rosicky,Rosicky,Midfielder,8083,0,2,1,0,3
11071,Raúl Jiménez,Jimenez,Forward,9827,2,0,0,1,3
39606,Sergio Reguilón,Reguilon,Defender,4170,0,1,1,1,3
2835,Armand Traore,Traore,Defender,6765,1,0,2,0,3
4499,Nathan Aké,Ake,Defender,13812,1,0,2,0,3
13522,Maximilian Kilman,Kilman,Defender,4180,0,1,2,0,3
3046,Kieran Gibbs,Gibbs,Defender,12937,2,0,0,1,3
13549,Tosin Adarabioyo,Adarabioyo,Defender,2954,0,1,1,1,3
10444,Pape Souaré,Souare,Defender,3898,1,0,1,1,3
3549,Francis Coquelin,Coquelin,Midfielder,6103,1,0,1,0,2
3830,Lee Chung-Yong,Chung-Yong,Midfielder,5698,0,2,0,0,2
52153,Moussa Djenepo,Djenepo,Midfielder,2619,1,0,1,0,2
5061,André Gomes,Gomes,Midfielder,5632,0,0,2,0,2
3876,Diniyar Bilyaletdinov,Bilyaletdinov,Midfielder,2881,2,0,0,0,2
3930,Anthony Henri Vanden Borre,Borre,Defender,1324,1,0,0,1,2
4103,Ramires,Ramires,Midfielder,11254,2,0,0,0,2
1673,Robbie Blake,Blake,Midfielder,1697,0,0,2,0,2
5490,Nordin Amrabat,Amrabat,Midfielder,2802,1,0,1,0,2
3829,Ivan Klasnic,Klasnic,Forward,3019,2,0,0,0,2
4196,Pablo Ibáñez,Ibanez,Defender,702,1,0,1,0,2
5064,Hélder Costa,Costa,Forward,2521,0,1,0,1,2
4401,Gerhard Tremmel,Tremmel,Goalkeeper,2387,0,2,0,0,2
66635,Cristian Romero,Romero,Defender,1846,0,1,1,0,2
5467,Alex Telles,Telles,Defender,2351,0,0,2,0,2
4488,Karim El Ahmadi,Ahmadi,Midfielder,3356,0,2,0,0,2
3835,Michael Duff,Duff,Defender,2760,1,0,1,0,2
4526,Oussama Assaidi,Assaidi,Midfielder,1408,0,2,0,0,2
3472,Sulley Muntari,Muntari,Midfielder,2913,2,0,0,0,2
5368,Sead Kolasinac,Kolasinac,Defender,5922,0,1,1,0,2
4408,Ben Davies,Davies,Defender,19310,0,1,1,0,2
4532,Matija Nastasic,Nastasic,Defender,2850,0,2,0,0,2
4416,Jazz Richards,Richards,Defender,1337,0,1,1,0,2
5343,Ricardo Pereira,Pereira,Defender,7595,0,0,2,0,2
356,Andrew Todd,Todd,Defender,1361,0,2,0,0,2
5110,Pierre-Emerick Aubameyang,Aubameyang,Forward,10303,1,0,0,1,2
4148,Yaya Touré,Toure,Midfielder,18244,0,2,0,0,2
4537,Alexander Büttner,Buttner,Defender,879,0,2,0,0,2
54900,Hassane Kamara,Kamara,Defender,1625,1,0,1,0,2
3482,Marek Matejovsky,Matejovsky,Midfielder,879,1,0,1,0,2
1676,Carlo Cudicini,Cudicini,Goalkeeper,2773,0,2,0,0,2
4509,John Lundstram,Lundstram,Midfielder,4487,1,1,0,0,2
4999,Son Heung-Min,Heung-Min,Forward,16152,2,0,0,0,2
3850,Steven Fletcher,Fletcher,Forward,13014,0,1,0,1,2
4507,Kevin Mirallas,Mirallas,Forward,8802,2,0,0,0,2
4539,Wilfried Zaha,Zaha,Forward,22356,2,0,0,0,2
3531,Gérald Cid,Cid,Defender,508,0,0,1,1,2
3901,Daniel Ayala,Ayala,Defender,1648,0,0,1,1,2
5093,Sokratis Papastathopoulos,Papastathopoulos,Defender,3896,0,1,1,0,2
3725,Ryan Mason,Mason,Midfielder,4051,0,2,0,0,2
4989,Philipp Wollscheid,Wollscheid,Defender,3872,0,1,1,0,2
4312,Doni,Doni,Goalkeeper,295,1,0,1,0,2
1526,Jermain Defoe,Defoe,Forward,20251,2,0,0,0,2
3762,Hérita Ilunga,Ilunga,Defender,5198,0,2,0,0,2
4812,Gary Hooper,Hooper,Forward,2029,0,2,0,0,2
1337,David Dunn,Dunn,Midfielder,7440,2,0,0,0,2
1005,James Beattie,Beattie,Forward,2608,0,1,0,1,2
4294,Royston Ricky Drenthe,Drenthe,Midfielder,1037,0,2,0,0,2
1495,Jermaine Pennant,Pennant,Midfielder,6034,0,0,2,0,2
3974,Vladimir Stojkovic,Stojkovic,Goalkeeper,360,0,2,0,0,2
1472,Stephen Bywater,Bywater,Goalkeeper,1620,0,2,0,0,2
4296,Nikica Jelavic,Jelavic,Forward,7229,0,2,0,0,2
4004,Adlène Guédioura,Guedioura,Midfielder,2903,0,0,2,0,2
1371,Hermann Hreidarsson,Hreidarsson,Defender,5690,1,0,1,0,2
4656,Ki Sung-Yeung,Sung-Yeung,Midfielder,13368,0,0,1,1,2
4313,Sebastián Coates,Coates,Defender,2768,0,0,1,1,2
3629,Ian Ashbee,Ashbee,Midfielder,2696,0,2,0,0,2
4772,Glenn Murray,Murray,Forward,7553,1,0,1,0,2
3672,Joe Bennett,Bennett,Defender,4774,1,0,1,0,2
4755,Dean Moxey,Moxey,Defender,1518,0,0,2,0,2
4736,Aron Gunnarsson,Gunnarsson,Midfielder,3814,0,2,0,0,2
908,Emile Heskey,Heskey,Forward,8345,1,0,1,0,2
3740,Ryan Donk,Donk,Defender,1252,0,0,2,0,2
37776,Jefferson Lerma,Lerma,Midfielder,5219,1,0,0,1,2
3737,Gianni Zuiverloon,Zuiverloon,Defender,3015,0,2,0,0,2
3980,Hendry Thomas,Thomas,Midfielder,4223,1,0,1,0,2
912,Tony Warner,Warner,Goalkeeper,270,0,2,0,0,2
3714,David Meyler,Meyler,Midfielder,6032,2,0,0,0,2
4713,Isaac Hayden,Hayden,Midfielder,8408,2,0,0,0,2
66094,Nuno Tavares,Tavares,Defender,1170,0,1,1,0,2
4363,Grant Holt,Holt,Forward,5191,1,0,1,0,2
45351,Marvelous Nakamba,Nakamba,Midfielder,3491,0,2,0,0,2
1634,Michael Carrick,Carrick,Midfielder,21434,0,0,1,1,2
4864,Conor Townsend,Townsend,Defender,2235,0,0,2,0,2
4077,David Vaughan,Vaughan,Midfielder,5525,1,0,0,1,2
3939,Frédéric Piquionne,Piquionne,Forward,4530,1,0,1,0,2
25311,Orestis Karnezis,Karnezis,Goalkeeper,1291,0,2,0,0,2
4554,Yoan Gouffran,Gouffran,Midfielder,5873,0,1,1,0,2
1632,Joe Cole,Cole,Midfielder,7347,1,0,1,0,2
4557,Steven Whittaker,Whittaker,Defender,3128,1,0,1,0,2
4395,James McClean,McClean,Midfielder,9444,1,0,0,1,2
4061,Matthew Gilks,Gilks,Goalkeeper,1575,0,2,0,0,2
4213,Demba Ba,Ba,Forward,6860,0,0,1,1,2
4951,Víctor Valdés,Valdes,Goalkeeper,2626,0,2,0,0,2
4918,Javier Manquillo,Manquillo,Defender,8733,0,0,2,0,2
4335,Ezekiel Fryers,Fryers,Defender,652,0,2,0,0,2
4877,Mike van der Hoorn,Hoorn,Defender,2610,0,0,2,0,2
49992,Adam Masina,Masina,Defender,3898,0,0,2,0,2
3622,Liam Cooper,Cooper,Defender,4126,1,0,1,0,2
4220,Piscu,Piscu,Defender,866,0,1,1,0,2
4224,James McArthur,McArthur,Midfielder,23018,0,0,2,0,2
3780,Hugo Rodallega,Rodallega,Forward,10715,1,0,1,0,2
4377,Samba Diakité,Diakite,Midfielder,1614,2,0,0,0,2
1042,Gavin McCann,McCann,Midfielder,5282,1,1,0,0,2
4043,Jean Makoun,Makoun,Midfielder,554,1,0,1,0,2
1017,Alan Stubbs,Stubbs,Defender,1209,0,1,1,0,2
4039,Marouane Chamakh,Chamakh,Forward,5877,0,0,2,0,2
4365,Steve Morison,Morison,Forward,2564,0,0,2,0,2
4031,Sébastien Squillaci,Squillaci,Defender,1826,0,1,0,1,2
3958,Ryan Fredericks,Fredericks,Defender,4192,0,1,1,0,2
47181,Samir,Samir,Defender,1675,0,2,0,0,2
3621,Andy Dawson,Dawson,Defender,5111,0,1,0,1,2
32796,Okay Yokuslu,Yokuslu,Midfielder,1319,0,0,2,0,2
16256,Neal Maupay,Maupay,Forward,7560,1,0,1,0,2
2069,Marcus Hahnemann,Hahnemann,Goalkeeper,6930,0,2,0,0,2
1815,Darren Moore,Moore,Defender,2465,0,2,0,0,2
2550,Gary O'Neil,O'Neil,Midfielder,8593,1,0,1,0,2
10483,Rolando Aarons,Aarons,Midfielder,642,0,1,1,0,2
3196,Stephen Hunt,Hunt,Midfielder,8373,0,0,2,0,2
8707,Dan Burn,Burn,Defender,8007,0,0,1,1,2
22542,Pascal Groß,Gross,Midfielder,11149,0,0,1,1,2
3189,André Bikey,Bikey,Defender,3555,0,1,1,0,2
8882,Philip Billing,Billing,Midfielder,5482,0,1,1,0,2
2110,John Arne Riise,Riise,Defender,9140,0,1,1,0,2
2553,Yakubu,Yakubu,Forward,7656,1,1,0,0,2
1849,Danny Shittu,Shittu,Defender,789,0,1,0,1,2
22047,Christoph Zimmermann,Zimmermann,Defender,1588,0,0,2,0,2
8945,Sam Byram,Byram,Defender,4098,1,0,1,0,2
2751,Tony McMahon,McMahon,Defender,1058,0,0,1,1,2
13565,Marcus Rashford,Rashford,Forward,13524,1,0,1,0,2
1869,Craig Bellamy,Bellamy,Forward,7266,1,1,0,0,2
3200,Brynjar Gunnarsson,Gunnarsson,Midfielder,1500,1,1,0,0,2
10487,Ayoze Pérez,Perez,Forward,13628,1,0,0,1,2
13089,Mateusz Klich,Klich,Midfielder,4474,0,0,2,0,2
3274,Hameur Bouazza,Bouazza,Midfielder,1198,1,0,1,0,2
8162,Bruno,Bruno,Defender,3153,0,1,1,0,2
12536,Denis Odoi,Odoi,Defender,2864,0,0,1,1,2
13957,Papy Djilobodji,Djilobodji,Defender,1577,1,1,0,0,2
2787,Ricardo Fuller,Fuller,Forward,5994,2,0,0,0,2
22698,Ezgjan Alioski,Alioski,Midfielder,2463,0,0,2,0,2
3279,Tyrone Mears,Mears,Defender,5519,0,1,1,0,2
8185,Joe Bryan,Bryan,Defender,3012,0,1,1,0,2
10498,Dusan Tadic,Tadic,Forward,9586,0,1,1,0,2
3247,Dimitar Berbatov,Berbatov,Forward,14792,0,0,1,1,2
2522,Cristiano Ronaldo,Ronaldo,Forward,7954,2,0,0,0,2
2523,David Jones,Jones,Midfielder,8513,0,0,2,0,2
3241,Adel Taarabt,Taarabt,Midfielder,5273,1,1,0,0,2
2529,James Morrison,Morrison,Midfielder,17682,1,0,1,0,2
13815,Kyle Walker-Peters,Walker-Peters,Defender,6788,0,1,1,0,2
2750,Andrew Taylor,Taylor,Defender,5073,0,2,0,0,2
8982,Anthony Knockaert,Knockaert,Midfielder,4589,2,0,0,0,2
21612,William Troost-Ekong,Troost-Ekong,Defender,1388,0,1,1,0,2
13389,Tom Davies,Davies,Midfielder,8201,0,1,1,0,2
19617,Nampalys Mendy,Mendy,Midfielder,5141,0,1,1,0,2
3114,Elliot Omozusi,Omozusi,Defender,689,1,0,1,0,2
1932,Dickson Etuhu,Etuhu,Midfielder,7407,0,2,0,0,2
13225,Sergi Canós,Canos,Forward,2103,1,0,0,1,2
3053,Denilson,Denilson,Midfielder,5881,0,0,2,0,2
13248,Hamza Choudhury,Choudhury,Midfielder,2462,1,1,0,0,2
10420,David Ospina,Ospina,Goalkeeper,2502,0,2,0,0,2
2723,Djibril Cissé,Cisse,Forward,4160,2,0,0,0,2
2662,Didier Drogba,Drogba,Forward,10981,2,0,0,0,2
2705,Tim Cahill,Cahill,Forward,11179,2,0,0,0,2
2701,Daniel Fox,Fox,Defender,2623,1,0,1,0,2
10000,Kortney Hause,Hause,Midfielder,2571,0,1,1,0,2
1947,Bradley Jones,Jones,Goalkeeper,2420,0,1,1,0,2
3069,André Ooijer,Ooijer,Defender,4691,0,1,0,1,2
3121,Clint Dempsey,Dempsey,Forward,16441,0,1,1,0,2
2624,Alex Bruce,Bruce,Defender,3042,0,1,1,0,2
10475,Ander Herrera,Herrera,Midfielder,8528,1,0,1,0,2
2612,Emmanuel Eboué,Eboue,Defender,5346,1,0,1,0,2
9100,Sam Clucas,Clucas,Midfielder,5230,1,0,1,0,2
13559,Axel Tuanzebe,Tuanzebe,Defender,1400,0,1,0,1,2
2583,Mark Davies,Davies,Midfielder,5021,1,0,1,0,2
13554,Kelechi Iheanacho,Iheanacho,Forward,6708,0,1,1,0,2
13515,James Justin,Justin,Defender,4077,0,0,1,1,2
10466,Willy Caballero,Caballero,Goalkeeper,3111,0,2,0,0,2
1929,Stephen Jordan,Jordan,Defender,2024,1,0,0,1,2
3126,Fábio Aurélio,Aurelio,Defender,4144,0,1,0,1,2
2619,Martin Laursen,Laursen,Defender,5077,0,0,1,1,2
19621,Marten de Roon,Roon,Midfielder,2777,0,0,2,0,2
2622,Gabriel Agbonlahor,Agbonlahor,Forward,22219,1,0,1,0,2
4129,Jon Flanagan,Flanagan,Defender,3685,0,1,1,0,2
3131,Danny Guthrie,Guthrie,Midfielder,7537,1,1,0,0,2
3127,Álvaro Arbeloa,Arbeloa,Defender,5108,0,1,1,0,2
8148,Stuart Dallas,Dallas,Midfielder,6332,0,1,1,0,2
8168,Dale Stephens,Stephens,Midfielder,8636,1,0,1,0,2
20708,Didier Ndong,Ndong,Midfielder,2519,0,1,1,0,2
3364,Liam Bridcutt,Bridcutt,Midfielder,1754,1,0,0,1,2
14575,Trevoh Chalobah,Chalobah,Defender,1449,0,1,1,0,2
7013,Jean Michaël Seri,Seri,Midfielder,2250,0,2,0,0,2
12173,Florent Hadergjonaj,Hadergjonaj,Defender,3512,0,1,1,0,2
6712,Timothy Castagne,Castagne,Defender,4472,0,2,0,0,2
2078,Steed Malbranque,Malbranque,Midfielder,9801,0,0,2,0,2
2199,Jay McEveley,McEveley,Defender,1908,0,2,0,0,2
15994,Allan,Allan,Midfielder,4238,1,1,0,0,2
11213,Roberto Pereyra,Pereyra,Midfielder,7136,1,1,0,0,2
5748,Alphonse Areola,Areola,Goalkeeper,3330,0,2,0,0,2
2409,Jens Lehmann,Lehmann,Goalkeeper,651,0,2,0,0,2
2076,Dean Leacock,Leacock,Defender,1997,0,0,1,1,2
11419,Martin Ødegaard,Odegaard,Midfielder,3657,0,0,2,0,2
20486,Leandro Trossard,Trossard,Forward,7443,0,1,1,0,2
20277,Jonny,Jonny,Defender,7188,0,2,0,0,2
5754,Thiago Silva,Silva,Defender,4589,1,1,0,0,2
10964,Rajiv van La Parra,Parra,Midfielder,2551,1,1,0,0,2
14824,Scott McTominay,McTominay,Midfielder,7876,0,1,1,0,2
11002,Jason Denayer,Denayer,Defender,1878,0,0,1,1,2
2382,Jason Koumas,Koumas,Midfielder,3069,1,1,0,0,2
14944,Todd Cantwell,Cantwell,Midfielder,2940,0,1,1,0,2
15116,Japhet Tanganga,Tanganga,Defender,1754,1,1,0,0,2
16286,Rodri,Rodri,Midfielder,8120,0,2,0,0,2
3389,Jack Rodwell,Rodwell,Midfielder,9580,1,1,0,0,2
2846,Wilfred Bouma,Bouma,Defender,3272,0,2,0,0,2
23704,Tariq Lamptey,Lamptey,Defender,3065,1,0,1,0,2
11111,Josip Drmic,Drmic,Forward,637,1,1,0,0,2
15687,Juninho Bacuna,Bacuna,Midfielder,1415,0,1,1,0,2
15608,Ragnar Klavan,Klavan,Defender,2857,0,1,1,0,2
11177,Bruno Martins Indi,Indi,Defender,4393,0,1,1,0,2
7114,Georginio Wijnaldum,Wijnaldum,Midfielder,17161,0,2,0,0,2
3361,Juliano Belletti,Belletti,Defender,3106,1,0,1,0,2
2844,Nicklas Bendtner,Bendtner,Forward,6808,1,1,0,0,2
2945,Fraizer Campbell,Campbell,Forward,7858,0,0,2,0,2
3316,Håvard Nordtveit,Nordtveit,Defender,1317,0,1,1,0,2
20503,Maxime Le Marchand,Marchand,Defender,2374,0,1,1,0,2
1804,Richard Garcia,Garcia,Forward,2266,0,1,0,1,2
2878,Abdoulaye Diagne-Faye,Diagne-Faye,Defender,8712,2,0,0,0,2
13961,Harry Wilson,Wilson,Midfielder,1651,0,0,2,0,2
11267,Aboubakar Kamara,Kamara,Forward,1000,1,0,1,0,2
8054,Eunan O'Kane,O'Kane,Midfielder,752,0,2,0,0,2
14063,Chris Mepham,Mepham,Defender,1761,0,2,0,0,2
12306,Daniel Amartey,Amartey,Defender,5733,1,0,1,0,2
3452,Danny Welbeck,Welbeck,Forward,14991,0,2,0,0,2
2463,Carlos Bocanegra,Bocanegra,Defender,1617,0,0,2,0,2
2195,Craig Fagan,Fagan,Forward,4732,1,0,1,0,2
2946,Emanuel Pogatetz,Pogatetz,Defender,4610,0,0,0,2,2
20183,Leon Balogun,Balogun,Defender,591,0,1,1,0,2
23396,Bruno Fernandes,Fernandes,Midfielder,7415,0,1,1,0,2
2942,Darron Gibson,Gibson,Midfielder,5519,1,0,1,0,2
23585,Álvaro Fernández,Fernandez,Goalkeeper,1080,0,1,0,1,2
2214,Robert Elliot,Elliot,Goalkeeper,4569,1,1,0,0,2
2823,Shaun Derry,Derry,Midfielder,3316,1,0,1,0,2
11247,Fabinho,Fabinho,Midfielder,8966,0,0,2,0,2
7564,Sofiane Feghouli,Feghouli,Midfielder,1038,1,0,1,0,2
2274,Adam Johnson,Johnson,Midfielder,14005,0,1,1,0,2
24221,Billy Gilmour,Gilmour,Midfielder,2309,0,0,2,0,2
7946,Demarai Gray,Gray,Forward,7873,0,2,0,0,2
2270,Aaron Lennon,Lennon,Midfielder,23976,0,0,2,0,2
7975,David Raya,Raya,Goalkeeper,2160,0,1,1,0,2
2206,Bernard Mendy,Mendy,Midfielder,2975,1,0,1,0,2
4525,Philippe Coutinho,Coutinho,Midfielder,12766,1,0,0,0,1
4516,Ashkan Dejagah,Dejagah,Midfielder,2494,0,0,1,0,1
4515,Giorgos Karagounis,Karagounis,Midfielder,2212,0,0,1,0,1
12365,Jordy Clasie,Clasie,Midfielder,2577,0,0,1,0,1
11363,Matheus Pereira,Pereira,Midfielder,2581,1,0,0,0,1
12949,Luciano Vietto,Vietto,Forward,985,0,0,1,0,1
12584,Sofiane Boufal,Boufal,Midfielder,3074,0,0,1,0,1
13279,Abdul Rahman Baba,Baba,Defender,1016,0,1,0,0,1
19771,Fabri,Fabri,Goalkeeper,180,0,1,0,0,1
4493,Jordan Bowery,Bowery,Forward,530,0,0,0,1,1
12186,Stuart Armstrong,Armstrong,Midfielder,7383,0,0,1,0,1
12817,Allan Saint-Maximin,Saint-Maximin,Forward,6247,0,0,1,0,1
12185,Kieran Tierney,Tierney,Defender,5211,0,0,1,0,1
12891,Timm Klose,Klose,Defender,1434,0,0,0,1,1
4453,Eggert Jónsson,Jonsson,Midfielder,173,0,0,1,0,1
13128,Jordan Veretout,Veretout,Midfielder,1824,0,1,0,0,1
52931,Alexandre Jankewitz,Jankewitz,Midfielder,3,1,0,0,0,1
4504,Bryan Oviedo,Oviedo,Defender,3317,0,0,0,1,1
4430,Tom Carroll,Carroll,Midfielder,5234,0,1,0,0,1
54312,Miguel Almirón,Almiron,Midfielder,7952,0,1,0,0,1
12512,Andrea Ranocchia,Ranocchia,Defender,1329,0,1,0,0,1
4414,Kemy Agustien,Agustien,Midfielder,1274,0,0,1,0,1
19680,Gabriel Jesus,Jesus,Forward,9306,0,0,1,0,1
13124,Jordan Amavi,Amavi,Defender,836,0,1,0,0,1
4421,Gylfi Sigurdsson,Sigurdsson,Midfielder,23144,0,1,0,0,1
5520,Stephan Lichtsteiner,Lichtsteiner,Defender,940,0,1,0,0,1
13280,Matt Miazga,Miazga,Defender,135,0,1,0,0,1
4240,Omar Elabdellaoui,Elabdellaoui,Defender,616,0,1,0,0,1
4204,Peter Odemwingie,Odemwingie,Forward,8621,1,0,0,0,1
4205,Saido Berahino,Berahino,Forward,7526,0,0,1,0,1
14656,Ryan Sessegnon,Sessegnon,Midfielder,3688,0,0,1,0,1
14624,Antonee Robinson,Robinson,Defender,2162,1,0,0,0,1
4226,Conor Sammon,Sammon,Forward,1044,1,0,0,0,1
14569,Marc Guéhi,Guehi,Defender,3223,0,0,1,0,1
14457,Josh Dasilva,Dasilva,Midfielder,252,1,0,0,0,1
4396,Connor Wickham,Wickham,Forward,6477,0,0,1,0,1
14451,Eddie Nketiah,Nketiah,Forward,1951,1,0,0,0,1
14446,Joseph Willock,Willock,Midfielder,4247,0,0,1,0,1
4247,André Santos,Santos,Midfielder,1407,0,1,0,0,1
66318,Jarrad Branthwaite,Branthwaite,Defender,687,1,0,0,0,1
14441,Josh Benson,Benson,Midfielder,261,0,0,1,0,1
4255,Gervinho,Gervinho,Forward,2703,1,0,0,0,1
14779,Kean Bryan,Bryan,Defender,1007,0,0,0,1,1
66494,Emil Krafth,Krafth,Defender,3944,0,1,0,0,1
4197,Gonzalo Jara,Jara,Defender,2311,1,0,0,0,1
14938,Jamal Lewis,Lewis,Defender,4399,0,0,1,0,1
4192,Rafael van der Vaart,Vaart,Midfielder,4644,0,0,1,0,1
15154,Dara O'Shea,O'Shea,Defender,2102,0,0,1,0,1
15480,Alireza Jahanbakhsh,Jahanbakhsh,Forward,1850,0,0,1,0,1
15481,Vincent Janssen,Janssen,Forward,869,0,0,1,0,1
4171,Hatem Ben Arfa,Arfa,Midfielder,4876,0,0,1,0,1
4166,James Perch,Perch,Defender,4016,0,0,0,1,1
71432,Rayan Aït-Nouri,Ait-Nouri,Defender,3230,0,0,1,0,1
16087,Trézéguet,Trezeguet,Midfielder,3126,1,0,0,0,1
4138,Luis Suárez,Suarez,Forward,9577,0,0,1,0,1
72119,Francisco Sierralta,Sierralta,Defender,428,0,0,0,1,1
76261,Jacob Sørensen,Sorensen,Midfielder,601,0,0,1,0,1
4134,Christian Poulsen,Poulsen,Midfielder,744,0,0,1,0,1
4133,Raul Meireles,Meireles,Midfielder,4610,0,1,0,0,1
16640,Marçal,Marcal,Defender,2074,0,0,1,0,1
4260,Jack Grealish,Grealish,Midfielder,8984,0,1,0,0,1
66284,Wesley Fofana,Fofana,Defender,2894,0,0,1,0,1
66104,Gabriel Martinelli,Martinelli,Midfielder,3108,1,0,0,0,1
13286,Tammy Abraham,Abraham,Forward,5028,0,0,0,1,1
19619,Aaron Mooy,Mooy,Midfielder,7487,1,0,0,0,1
4383,Alejandro Faurlin,Faurlin,Midfielder,2675,0,0,0,1,1
13390,Oumar Niasse,Niasse,Forward,3335,1,0,0,0,1
13477,Josh Tymon,Tymon,Defender,486,0,1,0,0,1
13490,Yohan Benalouane,Benalouane,Defender,1075,0,0,1,0,1
19611,Elias Kachunga,Kachunga,Forward,2519,0,0,1,0,1
4357,Wes Hoolahan,Hoolahan,Midfielder,7517,0,1,0,0,1
19609,Michael Hefele,Hefele,Defender,32,0,0,1,0,1
13511,Roberto Firmino,Firmino,Forward,17277,0,1,0,0,1
4347,Declan Rudd,Rudd,Goalkeeper,1089,0,0,1,0,1
19604,Nolito,Nolito,Forward,778,1,0,0,0,1
19603,Lys Mousset,Mousset,Forward,2721,0,0,0,1,1
4339,Davide Santon,Santon,Defender,6528,0,0,1,0,1
4331,Sam Johnstone,Johnstone,Goalkeeper,3330,0,0,1,0,1
4271,Anthony Modeste,Modeste,Forward,383,1,0,0,0,1
20097,Pablo Marí,Mari,Defender,1194,0,0,1,0,1
13716,Cuco Martina,Martina,Defender,3506,0,1,0,0,1
4328,Sergio Agüero,Aguero,Forward,19857,1,0,0,0,1
4324,David Pizarro,Pizarro,Midfielder,164,0,1,0,0,1
4321,Stefan Savic,Savic,Defender,541,0,1,0,0,1
13795,Kristoffer Nordfeldt,Nordfeldt,Goalkeeper,180,0,1,0,0,1
13796,Joe Rodon,Rodon,Defender,819,0,1,0,0,1
19601,Bernardo Espinosa,Espinosa,Defender,975,0,0,1,0,1
13797,Daniel James,James,Midfielder,5701,1,0,0,0,1
13813,Kevin Wimmer,Wimmer,Defender,2489,0,0,0,1,1
13871,Pedro Obiang,Obiang,Midfielder,5527,0,1,0,0,1
13872,Manuel Lanzini,Lanzini,Midfielder,11092,0,1,0,0,1
4288,Kevin De Bruyne,Bruyne,Midfielder,16079,0,1,0,0,1
4276,Tim Ream,Ream,Defender,3849,0,1,0,0,1
13702,Charlie Goode,Goode,Defender,448,0,0,1,0,1
10523,Benjamin Stambouli,Stambouli,Midfielder,453,0,0,1,0,1
11272,Anthony Martial,Martial,Forward,11728,1,0,0,0,1
4849,Morgan Amalfitano,Amalfitano,Midfielder,3331,0,0,1,0,1
4874,Joël Veltman,Veltman,Defender,5163,0,0,1,0,1
4880,Kenny Tete,Tete,Defender,1482,0,0,1,0,1
25892,Kevin Danso,Danso,Defender,276,1,0,0,0,1
25540,Mads Bech Sørensen,Sorensen,Defender,833,0,0,1,0,1
4936,Thomas Partey,Partey,Midfielder,3566,0,1,0,0,1
4941,Diego Costa,Costa,Forward,7550,0,1,0,0,1
8052,Ryan Fraser,Fraser,Midfielder,11405,1,0,0,0,1
25467,Enock Mwepu,Mwepu,Midfielder,994,0,0,1,0,1
8046,Tommy Elphick,Elphick,Defender,1012,0,0,1,0,1
4968,Ibrahim Afellay,Afellay,Midfielder,2645,1,0,0,0,1
4972,Pedro,Pedro,Forward,8156,0,1,0,0,1
23033,Lucas Torreira,Torreira,Midfielder,3887,1,0,0,0,1
4979,Adama Traoré,Traore,Forward,8922,0,1,0,0,1
7450,Michy Batshuayi,Batshuayi,Forward,2296,0,0,0,1,1
23556,Mathias Normann,Normann,Midfielder,1652,0,0,1,0,1
26076,Diego Rico,Rico,Defender,2941,0,0,1,0,1
4848,Diego Lugano,Lugano,Defender,659,0,0,1,0,1
7120,Memphis Depay,Depay,Forward,1494,0,1,0,0,1
4845,Christian Eriksen,Eriksen,Midfielder,19249,0,0,1,0,1
8888,Joe Lolley,Lolley,Forward,219,0,1,0,0,1
8691,Charlie Taylor,Taylor,Defender,11294,0,1,0,0,1
31905,Cucho Hernández,Hernandez,Forward,1140,0,0,0,1,1
8658,Ollie Watkins,Watkins,Forward,6284,1,0,0,0,1
8636,Aiden McGeady,McGeady,Midfielder,1357,0,1,0,0,1
31861,Albert Sambi Lokonga,Lokonga,Midfielder,1133,0,1,0,0,1
30533,Aaron Rowe,Rowe,Forward,69,0,0,1,0,1
8456,James Maddison,Maddison,Midfielder,10045,1,0,0,0,1
8438,Cyrus Christie,Christie,Defender,1945,0,0,1,0,1
22546,Kiko Femenía,Femenia,Defender,8150,0,0,1,0,1
22570,Steve Mounié,Mounie,Forward,3634,1,0,0,0,1
8242,Scott Arfield,Arfield,Midfielder,6643,0,0,1,0,1
4838,Wilfried Bony,Bony,Forward,6687,1,0,0,0,1
22575,Roque Mesa,Mesa,Midfielder,757,0,0,1,0,1
8171,Solly March,March,Midfielder,8874,0,0,1,0,1
7198,Yann M'Vila,M'Vila,Midfielder,3188,0,0,1,0,1
5051,João Cancelo,Cancelo,Defender,6735,1,0,0,0,1
22040,Mario Vrancic,Vrancic,Midfielder,628,0,1,0,0,1
5178,Mohamed Salah,Salah,Forward,15431,0,1,0,0,1
5239,Mohamed Elneny,Elneny,Midfielder,5079,1,0,0,0,1
5264,Thiago,Thiago,Midfielder,3391,0,0,1,0,1
24635,Eric García,Garcia,Defender,1170,0,0,1,0,1
24156,Raphinha,Raphinha,Forward,5285,0,0,1,0,1
5344,Fernando,Fernando,Midfielder,4137,0,1,0,0,1
5696,Eduardo Vargas,Vargas,Forward,1385,0,0,1,0,1
5365,Jan Kirchhoff,Kirchhoff,Defender,1519,0,0,1,0,1
5688,Pablo Armero,Armero,Defender,322,0,0,1,0,1
24252,Diogo Dalot,Dalot,Defender,2879,0,0,1,0,1
5588,Giannelli Imbula,Imbula,Midfielder,2056,0,0,0,1,1
24334,Tyrick Mitchell,Mitchell,Defender,5005,0,0,1,0,1
5586,Dimitri Payet,Payet,Midfielder,4084,0,1,0,0,1
5583,Mario Lemina,Lemina,Midfielder,5038,0,1,0,0,1
5566,Steve Mandanda,Mandanda,Goalkeeper,810,0,1,0,0,1
5551,Fernando Llorente,Llorente,Forward,3362,0,0,0,1,1
23811,Neco Williams,Williams,Defender,485,0,0,1,0,1
5794,Ángel Di María,Maria,Midfielder,1642,0,1,0,0,1
6784,Felipe Anderson,Anderson,Midfielder,4558,0,0,1,0,1
5156,Beram Kayal,Kayal,Midfielder,1677,0,0,1,0,1
6671,Andrej Kramaric,Kramaric,Forward,596,0,1,0,0,1
6609,Ahmed Hegazi,Hegazi,Defender,3477,0,1,0,0,1
5067,Bernardo Silva,Silva,Midfielder,11332,0,0,1,0,1
6528,Valentino Lazaro,Lazaro,Midfielder,473,1,0,0,0,1
5079,Ivan Cavaleiro,Cavaleiro,Forward,3159,0,0,1,0,1
23593,Ibrahima Konaté,Konate,Defender,990,0,1,0,0,1
6387,Jeremain Lens,Lens,Midfielder,1361,1,0,0,0,1
25068,Morgan Sanson,Sanson,Midfielder,643,0,1,0,0,1
5101,Ilkay Gündogan,Gundogan,Midfielder,10257,0,0,1,0,1
5102,Henrikh Mkhitaryan,Mkhitaryan,Midfielder,4831,0,0,1,0,1
6251,Henri Saivet,Saivet,Midfielder,232,0,1,0,0,1
24773,Shandon Baptiste,Baptiste,Midfielder,905,1,0,0,0,1
6210,Jóhann Gudmundsson,Gudmundsson,Midfielder,8675,0,0,1,0,1
5860,Dennis Praet,Praet,Midfielder,1855,0,0,1,0,1
5810,Claudio Bravo,Bravo,Goalkeeper,2540,0,1,0,0,1
32162,André-Frank Zambo Anguissa,Anguissa,Midfielder,4103,1,0,0,0,1
8976,Andy King,King,Midfielder,5117,0,1,0,0,1
4541,Adnan Januzaj,Januzaj,Midfielder,4263,1,0,0,0,1
10527,Sébastien Pocognoli,Pocognoli,Defender,1249,0,0,1,0,1
49961,Lyanco,Lyanco,Defender,906,0,1,0,0,1
5511,Mauricio Isla,Isla,Defender,2131,0,1,0,0,1
10517,Stephen Kingsley,Kingsley,Defender,1392,0,0,0,1,1
49610,Ibrahima Diallo,Diallo,Midfielder,2030,0,0,1,0,1
49481,Bukayo Saka,Saka,Forward,7311,0,0,0,1,1
10492,Cole Kpekawa,Kpekawa,Defender,5,0,1,0,0,1
10488,Emmanuel Rivière,Riviere,Forward,1276,0,0,1,0,1
20517,Saïd Benrahma,Benrahma,Forward,3573,0,0,1,0,1
20538,Papa Ndiaye,Ndiaye,Midfielder,1140,0,0,1,0,1
10479,Freddie Woodman,Woodman,Goalkeeper,360,0,1,0,0,1
4618,Adam Lallana,Lallana,Midfielder,15807,0,0,1,0,1
4619,Guly do Prado,Prado,Midfielder,833,0,0,0,1,1
10476,Andreas Pereira,Pereira,Midfielder,2175,0,1,0,0,1
4626,Billy Sharp,Sharp,Forward,1795,1,0,0,0,1
10473,Patrick McNair,McNair,Midfielder,1689,0,0,0,1,1
4587,Jay Tabb,Tabb,Midfielder,1020,0,0,1,0,1
10543,Sheyi Ojo,Ojo,Midfielder,396,0,1,0,0,1
20701,Emmanuel Dennis,Dennis,Forward,2589,1,0,0,0,1
49990,Ibrahim Amadou,Amadou,Midfielder,756,0,0,1,0,1
4543,Jak Alnwick,Alnwick,Goalkeeper,495,0,1,0,0,1
50512,Mattéo Guendouzi,Guendouzi,Midfielder,3890,0,1,0,0,1
11180,Rúben Neves,Neves,Midfielder,11409,0,1,0,0,1
11134,Jon Stankovic,Stankovic,Defender,719,0,1,0,0,1
50453,Mark Travers,Travers,Goalkeeper,270,0,1,0,0,1
50252,Nicolas Pépé,Pepe,Forward,4308,1,0,0,0,1
10947,Rico Henry,Henry,Defender,2784,0,0,1,0,1
10905,Che Adams,Adams,Forward,5819,0,1,0,0,1
4566,Julio César,Cesar,Goalkeeper,2100,0,0,0,1,1
4568,Yun Suk-Young,Suk-Young,Defender,1725,0,1,0,0,1
10832,Vadis Odjidja-Ofoe,Odjidja-Ofoe,Midfielder,275,0,0,1,0,1
4569,Stéphane Mbia,Mbia,Midfielder,2371,1,0,0,0,1
4572,Loïc Rémy,Remy,Forward,4551,1,0,0,0,1
10768,Kalvin Phillips,Phillips,Midfielder,4024,0,1,0,0,1
10766,Lewis Cook,Cook,Midfielder,4737,0,1,0,0,1
10462,Esteban Cambiasso,Cambiasso,Midfielder,2423,0,0,0,1,1
4645,Alfred N'Diaye,N'Diaye,Midfielder,2575,0,0,1,0,1
4791,Yannick Sagbo,Sagbo,Forward,1553,1,0,0,0,1
33046,Junior Firpo,Firpo,Defender,1715,0,0,0,1,1
4734,Kim Bo-Kyung,Bo-Kyung,Midfielder,1674,0,0,1,0,1
9169,George Baldock,Baldock,Defender,6209,0,1,0,0,1
4754,Jonathan Parr,Parr,Defender,756,0,0,1,0,1
21297,Mads Roerslev,Roerslev,Defender,1233,0,0,1,0,1
9167,Dele Alli,Alli,Midfielder,13782,0,1,0,0,1
9163,Brendan Galloway,Galloway,Defender,1645,0,0,1,0,1
4763,Yannick Bolasie,Bolasie,Forward,8796,1,0,0,0,1
32638,Konstantinos Mavropanos,Mavropanos,Defender,344,1,0,0,0,1
4771,Dwight Gayle,Gayle,Forward,6089,1,0,0,0,1
21584,Eberechi Eze,Eze,Midfielder,3164,0,1,0,0,1
9030,Brad Smith,Smith,Defender,587,1,0,0,0,1
21585,Lloyd Kelly,Kelly,Defender,638,0,1,0,0,1
21730,Molla Wagué,Wague,Defender,440,0,0,1,0,1
4786,Eldin Jakupovic,Jakupovic,Goalkeeper,2477,0,1,0,0,1
4788,George Boyd,Boyd,Forward,7061,0,0,1,0,1
4727,Simon Moore,Moore,Goalkeeper,180,0,1,0,0,1
9468,Charlie Austin,Austin,Forward,6360,1,0,0,0,1
10451,Muhamed Besic,Besic,Midfielder,2132,0,1,0,0,1
4719,Jores Okore,Okore,Defender,3256,0,0,1,0,1
10449,Jonjoe Kenny,Kenny,Defender,3548,1,0,0,0,1
4657,Jonathan de Guzmán,Guzman,Midfielder,5213,0,0,0,1,1
10123,Marvin Zeegelaar,Zeegelaar,Defender,995,1,0,0,0,1
37587,Florin Andone,Andone,Forward,945,1,0,0,0,1
10074,Joe Ralls,Ralls,Midfielder,1960,1,0,0,0,1
4671,Goran Popov,Popov,Defender,970,1,0,0,0,1
9943,Almen Abdi,Abdi,Midfielder,1984,0,0,1,0,1
4697,Iván Ramis,Ramis,Defender,1398,0,0,1,0,1
9895,Matthew Pennington,Pennington,Defender,479,0,0,1,0,1
9762,Daniel Bachmann,Bachmann,Goalkeeper,1080,0,0,1,0,1
4707,Kei Kamara,Kamara,Forward,656,0,0,1,0,1
9662,Jacob Murphy,Murphy,Midfielder,4525,0,0,1,0,1
20810,Kai Havertz,Havertz,Midfielder,3331,0,1,0,0,1
9576,Dominic Calvert-Lewin,Calvert-Lewin,Forward,10783,0,1,0,0,1
9491,Jack O'Connell,O'Connell,Defender,3095,0,1,0,0,1
4130,Andre Wisdom,Wisdom,Defender,3890,0,0,1,0,1
59,Dwight Yorke,Yorke,Midfielder,1527,1,0,0,0,1
3026,Pascal Chimbonda,Chimbonda,Defender,6390,0,1,0,0,1
3754,Marc-Antoine Fortuné,Fortune,Forward,4467,1,0,0,0,1
3867,John Heitinga,Heitinga,Defender,9880,0,0,0,1,1
3863,Fabio Borini,Borini,Forward,6710,1,0,0,0,1
2695,Andrew Johnson,Johnson,Forward,7950,1,0,0,0,1
1692,Robbie Keane,Keane,Forward,7577,1,0,0,0,1
1695,Chris Riggott,Riggott,Defender,2244,0,0,0,1,1
1710,Sami Hyypiä,Hyypia,Defender,3115,0,0,0,1,1
2686,Ben Watson,Watson,Midfielder,8315,1,0,0,0,1
1719,Mikaël Silvestre,Silvestre,Defender,2137,0,0,1,0,1
3845,Wade Elliott,Elliott,Midfielder,3121,0,0,1,0,1
2671,Leon Cort,Cort,Defender,2133,0,1,0,0,1
3844,Kevin McDonald,McDonald,Midfielder,2298,1,0,0,0,1
3843,Christopher McCann,McCann,Midfielder,491,0,0,1,0,1
3842,Graham Alexander,Alexander,Defender,2747,0,1,0,0,1
3825,Nikola Kalinic,Kalinic,Forward,2518,1,0,0,0,1
2636,Morten Gamst Pedersen,Pedersen,Midfielder,13202,1,0,0,0,1
2616,Robin van Persie,Persie,Forward,16456,1,0,0,0,1
2604,Ivar Ingimarsson,Ingimarsson,Defender,3001,0,0,0,1,1
2603,Bobby Zamora,Zamora,Forward,12097,1,0,0,0,1
1757,Kevin Kilbane,Kilbane,Midfielder,5892,1,0,0,0,1
3803,Andreas Weimann,Weimann,Forward,7225,0,0,1,0,1
3397,Leon Andreasen,Andreasen,Midfielder,817,1,0,0,0,1
1772,Matthew Etherington,Etherington,Midfielder,13055,1,0,0,0,1
1775,Simon Davies,Davies,Midfielder,9624,0,0,0,1,1
3426,Vedran Corluka,Corluka,Defender,10069,0,0,0,1,1
3427,Javier Garrido,Garrido,Defender,7077,0,0,1,0,1
1830,Moritz Volz,Volz,Defender,484,1,0,0,0,1
2557,Stephen Crainey,Crainey,Defender,2748,0,1,0,0,1
3761,Radoslav Kovác,Kovac,Midfielder,3615,1,0,0,0,1
3757,Roman Bednar,Bednar,Forward,1363,0,0,1,0,1
3877,Adam Forshaw,Forshaw,Midfielder,4236,0,1,0,0,1
2740,Liam Miller,Miller,Midfielder,1685,1,0,0,0,1
1656,Jérémie Aliadière,Aliadiere,Forward,4437,1,0,0,0,1
2815,Mido,Mido,Forward,2615,1,0,0,0,1
3212,Claude Davis,Davis,Defender,1540,1,0,0,0,1
1331,Martin Taylor,Taylor,Defender,255,1,0,0,0,1
1336,Damien Johnson,Johnson,Midfielder,1416,1,0,0,0,1
3962,Manuel da Costa,Costa,Defender,2387,0,0,1,0,1
3957,Steven Caulker,Caulker,Defender,10498,0,0,0,1,1
3225,Stephen Quinn,Quinn,Midfielder,2140,1,0,0,0,1
1379,Hayden Mullins,Mullins,Midfielder,6138,0,1,0,0,1
3243,Didier Zokora,Zokora,Midfielder,4314,0,1,0,0,1
3951,Lorik Cana,Cana,Defender,2597,1,0,0,0,1
3949,Paulo Da Silva,Silva,Defender,1250,0,1,0,0,1
3283,Andreas Granqvist,Granqvist,Defender,1171,0,0,1,0,1
3926,Joshua King,King,Forward,14472,0,0,1,0,1
3925,Mame Biram Diouf,Diouf,Forward,9403,0,0,1,0,1
3924,Oliver Norwood,Norwood,Midfielder,5324,0,0,1,0,1
3353,Tamir Cohen,Cohen,Midfielder,2933,1,0,0,0,1
1437,Andy Griffin,Griffin,Defender,2750,0,1,0,0,1
3318,Eduardo da Silva,Silva,Forward,2085,0,1,0,0,1
3324,Eric Lichaj,Lichaj,Defender,2231,0,0,1,0,1
3908,Dedryck Boyata,Boyata,Defender,1740,1,0,0,0,1
2803,Erik Edman,Edman,Defender,633,0,1,0,0,1
2802,Noé Pamarot,Pamarot,Defender,2168,1,0,0,0,1
2796,Kenwyne Jones,Jones,Forward,13067,1,0,0,0,1
1589,Steven Caldwell,Caldwell,Defender,1874,1,0,0,0,1
3902,Jack Robinson,Robinson,Defender,1529,0,0,1,0,1
1598,Louis Saha,Saha,Forward,7441,0,1,0,0,1
1609,Marlon Harewood,Harewood,Forward,1213,0,0,1,0,1
3897,Jozy Altidore,Altidore,Forward,3541,1,0,0,0,1
2766,Jason Shackell,Shackell,Defender,3347,0,0,0,1,1
3756,Chris Wood,Wood,Forward,12257,0,0,0,1,1
3433,Geovanni,Geovanni,Midfielder,4474,1,0,0,0,1
3208,Simon Cox,Cox,Forward,1524,0,0,1,0,1
3435,Martin Petrov,Petrov,Midfielder,8078,1,0,0,0,1
2101,Caleb Folan,Folan,Forward,1035,1,0,0,0,1
3669,Matty James,James,Midfielder,2890,1,0,0,0,1
2119,David Murphy,Murphy,Defender,1680,0,0,1,0,1
2127,Jermaine Jenas,Jenas,Midfielder,8163,0,0,1,0,1
3510,Chris Gunter,Gunter,Defender,1996,0,0,1,0,1
2151,Elliott Ward,Ward,Defender,1080,0,1,0,0,1
2152,Leon Britton,Britton,Midfielder,11115,0,0,1,0,1
2163,Justin Hoyte,Hoyte,Defender,1758,0,0,0,1,1
3659,Nigel de Jong,Jong,Midfielder,7747,0,0,1,0,1
3658,Adam Clayton,Clayton,Midfielder,2806,0,1,0,0,1
3650,David N'Gog,N'Gog,Forward,4469,0,0,1,0,1
3533,Robert Malcolm,Malcolm,Midfielder,59,0,1,0,0,1
3646,Andrea Dossena,Dossena,Defender,1585,1,0,0,0,1
3643,Philipp Degen,Degen,Defender,327,1,0,0,0,1
2390,Zoltán Gera,Gera,Midfielder,6482,1,0,0,0,1
2385,Jason Roberts,Roberts,Forward,7179,1,0,0,0,1
3539,David Rozehnal,Rozehnal,Defender,1487,0,1,0,0,1
2183,Mat Sadler,Sadler,Defender,239,0,0,1,0,1
3546,Samir Nasri,Nasri,Midfielder,15616,1,0,0,0,1
3551,Emmanuel Frimpong,Frimpong,Midfielder,733,1,0,0,0,1
3565,Barry Bannan,Bannan,Midfielder,4652,0,0,1,0,1
3571,Vince Grella,Grella,Midfielder,2500,1,0,0,0,1
2338,Andrew Surman,Surman,Midfielder,11240,1,0,0,0,1
3603,Segundo Castillo,Castillo,Midfielder,989,0,0,1,0,1
2329,Antti Niemi,Niemi,Goalkeeper,1980,0,1,0,0,1
2260,Matthew Kilgallon,Kilgallon,Defender,1917,0,0,0,1,1
2322,Bradley Orr,Orr,Defender,1284,0,1,0,0,1
2289,El Hadji Diouf,Diouf,Midfielder,8319,0,0,1,0,1
2307,Danny Pugh,Pugh,Defender,1731,0,0,1,0,1
3676,Didier Digard,Digard,Midfielder,1296,1,0,0,0,1
2098,Darren Bent,Bent,Forward,13820,0,1,0,0,1
3683,Jonás Gutiérrez,Gutierrez,Midfielder,12272,1,0,0,0,1
1986,James Harper,Harper,Midfielder,3353,0,0,1,0,1
3436,Gelson Fernandes,Fernandes,Midfielder,2439,1,0,0,0,1
2547,Amdy Faye,Faye,Midfielder,1408,1,0,0,0,1
2531,Danny Graham,Graham,Forward,6669,0,0,0,1,1
2527,Matthew Bates,Bates,Defender,1381,1,0,0,0,1
1889,Wayne Brown,Brown,Defender,90,0,1,0,0,1
2521,David Fox,Fox,Midfielder,1967,0,1,0,0,1
3738,Shelton Martis,Martis,Defender,552,0,1,0,0,1
2507,Keiren Westwood,Westwood,Goalkeeper,1610,0,1,0,0,1
1934,Shaun Wright-Phillips,Wright-Phillips,Midfielder,9623,0,1,0,0,1
3458,Jonathan Grounds,Grounds,Defender,568,0,0,0,1,1
1962,Shola Ameobi,Ameobi,Forward,6291,1,0,0,0,1
2471,Darren Pratley,Pratley,Midfielder,1271,0,0,1,0,1
1972,Julio Arca,Arca,Midfielder,3027,0,1,0,0,1
1999,Jamie Ashdown,Ashdown,Goalkeeper,721,0,1,0,0,1
3491,Russell Anderson,Anderson,Defender,28,0,0,1,0,1
3723,Luka Modric,Modric,Midfielder,10720,0,0,1,0,1
3463,Caçapa,Cacapa,Defender,1794,0,1,0,0,1
2012,Olof Mellberg,Mellberg,Defender,2964,1,0,0,0,1
2024,Tugay,Tugay,Midfielder,2677,1,0,0,0,1
3705,Seyi Olofinjana,Olofinjana,Midfielder,2360,0,0,1,0,1
2041,Ricardo Gardner,Gardner,Midfielder,5655,1,0,0,0,1
2056,Boudewijn Zenden,Zenden,Midfielder,1611,1,0,0,0,1
3478,David Nugent,Nugent,Forward,5334,0,0,1,0,1
2072,Steve Finnan,Finnan,Defender,3765,0,0,1,0,1
2081,Eddie Lewis,Lewis,Midfielder,1912,0,0,0,1,1
3484,Hal Robson-Kanu,Robson-Kanu,Forward,3325,1,0,0,0,1
2434,Brett Emerton,Emerton,Midfielder,8179,1,0,0,0,1
2433,Barry Ferguson,Ferguson,Midfielder,6478,1,0,0,0,1
2861,DJ Campbell,Campbell,Forward,2946,1,0,0,0,1
2719,Xabi Alonso,Alonso,Midfielder,4030,0,0,0,1,1
4000,Matthew Jarvis,Jarvis,Midfielder,14549,0,1,0,0,1
4066,Neal Eardley,Eardley,Defender,2558,0,0,0,1,1
4095,Rodrigo,Rodrigo,Forward,4051,0,0,1,0,1
958,Matt Oakley,Oakley,Midfielder,1671,0,0,1,0,1
1132,Patrick Vieira,Vieira,Midfielder,1301,0,0,1,0,1
3192,Gregory Halford,Halford,Defender,1593,1,0,0,0,1
4003,George Friend,Friend,Defender,2021,0,1,0,0,1
3993,Kevin Foley,Foley,Defender,5775,0,0,1,0,1
3185,Graeme Murty,Murty,Defender,2423,0,1,0,0,1
3103,Michael Ballack,Ballack,Midfielder,5806,1,0,0,0,1
1190,Lee Bowyer,Bowyer,Midfielder,6417,0,1,0,0,1
3097,Henrique Hilário,Hilario,Goalkeeper,694,0,1,0,0,1
3080,Benni McCarthy,McCarthy,Forward,4153,1,0,0,0,1
4016,Christian Kalvenes,Kalvenes,Defender,277,0,1,0,0,1
1185,Michael Ball,Ball,Defender,2580,0,1,0,0,1
3084,Lubomir Michalik,Michalik,Defender,496,0,0,0,1,1
4067,Alex Baptiste,Baptiste,Defender,1729,0,1,0,0,1
669,Michael Duberry,Duberry,Defender,1023,0,0,0,1,1
2985,Daryl Murphy,Murphy,Forward,2591,0,0,0,1,1
1175,Lee Carsley,Carsley,Midfielder,3222,0,0,1,0,1
4074,Matt Phillips,Phillips,Midfielder,8973,0,0,1,0,1
4001,Nenad Milijas,Milijas,Midfielder,3420,1,0,0,0,1
3135,Dirk Kuyt,Kuyt,Midfielder,13183,0,1,0,0,1
3182,Adam Federici,Federici,Goalkeeper,2565,0,1,0,0,1
1242,Maik Taylor,Taylor,Goalkeeper,3240,0,0,1,0,1
2982,Grant Leadbitter,Leadbitter,Midfielder,3745,0,1,0,0,1
4033,Ignasi Miquel,Miquel,Defender,218,0,1,0,0,1
4087,Luke Varney,Varney,Forward,2045,0,0,1,0,1
4123,Mousa Dembélé,Dembele,Midfielder,16944,0,0,1,0,1
4051,Nikola Zigic,Zigic,Forward,1310,0,0,1,0,1
2866,Zurab Khizanishvili,Khizanishvili,Defender,1255,0,1,0,0,1
4048,Jean Beausejour,Beausejour,Midfielder,5072,0,0,1,0,1
3205,Kevin Doyle,Doyle,Forward,10484,0,0,0,1,1
3107,Salomon Kalou,Kalou,Midfielder,6725,0,0,1,0,1
3981,Jordi Gómez,Gomez,Midfielder,7598,1,0,0,0,1
3067,Jason Brown,Brown,Goalkeeper,649,0,1,0,0,1
3982,Mohamed Diamé,Diame,Midfielder,17334,0,1,0,0,1
2893,Lassana Diarra,Diarra,Midfielder,2277,1,0,0,0,1
2928,Stephen Ireland,Ireland,Midfielder,12656,1,0,0,0,1
2912,David Martin,Martin,Goalkeeper,435,0,1,0,0,1
3207,Dave Kitson,Kitson,Forward,4234,1,0,0,0,1
2905,Victor Anichebe,Anichebe,Forward,8885,1,0,0,0,1
4009,Stefan Maierhofer,Maierhofer,Forward,180,1,0,0,0,1
2971,Kelvin Davis,Davis,Goalkeeper,1741,0,1,0,0,1
14608,Jayden Bogle,Bogle,Defender,1107,0,0,0,0,0
2464,Liam Rosenior,Rosenior,Defender,3974,0,0,0,0,0
2443,Stelios Giannakopoulos,Giannakopoulos,Midfielder,314,0,0,0,0,0
10528,Cristian Gamboa,Gamboa,Defender,263,0,0,0,0,0
10535,Reece Oxford,Oxford,Defender,213,0,0,0,0,0
14445,Emile Smith Rowe,Rowe,Midfielder,3465,0,0,0,0,0
2447,Ricardo Vaz Tê,Te,Forward,2167,0,0,0,0,0
10532,Tyler Roberts,Roberts,Forward,2332,0,0,0,0,0
2981,Liam Lawrence,Lawrence,Midfielder,2936,0,0,0,0,0
10526,Jason Davidson,Davidson,Defender,102,0,0,0,0,0
14580,Mason Mount,Mount,Midfielder,8128,0,0,0,0,0
14450,Reiss Nelson,Nelson,Forward,862,0,0,0,0,0
2452,Alexei Smertin,Smertin,Midfielder,989,0,0,0,0,0
14452,Nathan Tella,Tella,Midfielder,1555,0,0,0,0,0
2437,Matt Derbyshire,Derbyshire,Forward,1753,0,0,0,0,0
2972,Ben Alnwick,Alnwick,Goalkeeper,90,0,0,0,0,0
2454,Claude Makelele,Makelele,Midfielder,1221,0,0,0,0,0
2460,James McFadden,McFadden,Midfielder,4526,0,0,0,0,0
11323,Víctor Ibarbo,Ibarbo,Forward,64,0,0,0,0,0
14428,João Virgínia,Virginia,Goalkeeper,47,0,0,0,0,0
2505,Zak Whitbread,Whitbread,Defender,1440,0,0,0,0,0
2530,Cameron Jerome,Jerome,Forward,12806,0,0,0,0,0
10596,Oliver Burke,Burke,Midfielder,1628,0,0,0,0,0
2524,Chris Eagles,Eagles,Midfielder,4402,0,0,0,0,0
2969,Benjani,Benjani,Forward,4364,0,0,0,0,0
13824,José Manuel Jurado,Jurado,Midfielder,2025,0,0,0,0,0
13866,Jonathan Leko,Leko,Forward,382,0,0,0,0,0
13867,Sam Field,Field,Midfielder,880,0,0,0,0,0
13869,Kyle Edwards,Edwards,Midfielder,113,0,0,0,0,0
10559,Daniel Agyei,Agyei,Forward,23,0,0,0,0,0
2513,Antoine Sibierski,Sibierski,Forward,1030,0,0,0,0,0
10548,Sebastián Blanco,Blanco,Midfielder,36,0,0,0,0,0
13875,Emmanuel Emenike,Emenike,Forward,509,0,0,0,0,0
13917,Connor Roberts,Roberts,Defender,1959,0,0,0,0,0
2477,Andy Keogh,Keogh,Forward,782,0,0,0,0,0
14393,Jamie Shackleton,Shackleton,Midfielder,1162,0,0,0,0,0
13985,Marko Grujic,Grujic,Midfielder,52,0,0,0,0,0
2475,Salomon Olembé,Olembe,Midfielder,198,0,0,0,0,0
14051,Nathaniel Phillips,Phillips,Defender,1455,0,0,0,0,0
2970,Franck Songo'o,Songo'o,Midfielder,25,0,0,0,0,0
10541,Enner Valencia,Valencia,Forward,4035,0,0,0,0,0
2472,Collins John,John,Forward,34,0,0,0,0,0
10540,Diafra Sakho,Sakho,Forward,3760,0,0,0,0,0
14170,Levi Lumeka,Lumeka,Forward,25,0,0,0,0,0
2424,Luke Moore,Moore,Forward,2564,0,0,0,0,0
14283,George Hirst,Hirst,Forward,9,0,0,0,0,0
14298,Michael Folivi,Folivi,Forward,9,0,0,0,0,0
10539,Josh Cullen,Cullen,Midfielder,7,0,0,0,0,0
10538,Nenê,Nene,Midfielder,128,0,0,0,0,0
14623,Beni Baningime,Baningime,Midfielder,193,0,0,0,0,0
14742,Rhian Brewster,Brewster,Forward,1123,0,0,0,0,0
14636,Nathan Broadhead,Broadhead,Forward,2,0,0,0,0,0
15013,Jake Vokins,Vokins,Defender,156,0,0,0,0,0
15045,Lasse Sørensen,Sorensen,Midfielder,76,0,0,0,0,0
15038,Thomas Edwards,Edwards,Defender,483,0,0,0,0,0
2994,Jamie O'Hara,O'Hara,Midfielder,6532,0,0,0,0,0
15019,Daniel N'Lundulu,N'Lundulu,Forward,102,0,0,0,0,0
15017,Tyreke Johnson,Johnson,Forward,1,0,0,0,0,0
10484,Rémy Cabella,Cabella,Midfielder,1947,0,0,0,0,0
2339,Richard Chaplow,Chaplow,Midfielder,52,0,0,0,0,0
15079,Joel Asoro,Asoro,Forward,9,0,0,0,0,0
15002,Callum Slattery,Slattery,Midfielder,110,0,0,0,0,0
14997,William Smallbone,Smallbone,Forward,699,0,0,0,0,0
2993,Hossam Ghaly,Ghaly,Midfielder,1106,0,0,0,0,0
2340,David McGoldrick,McGoldrick,Forward,4223,0,0,0,0,0
2992,Teemu Tainio,Tainio,Midfielder,2443,0,0,0,0,0
2989,Paul Stalteri,Stalteri,Defender,1372,0,0,0,0,0
15052,Julien Ngoy,Ngoy,Forward,63,0,0,0,0,0
10482,Jamie Sterry,Sterry,Defender,6,0,0,0,0,0
14637,Nathan Holland,Holland,Midfielder,31,0,0,0,0,0
15259,Morgan Gibbs-White,Gibbs-White,Midfielder,1193,0,0,0,0,0
2313,Andrew Davies,Davies,Defender,325,0,0,0,0,0
15374,Josh Sims,Sims,Midfielder,576,0,0,0,0,0
3022,Mike Pollitt,Pollitt,Goalkeeper,679,0,0,0,0,0
15293,Jayson Molumby,Molumby,Midfielder,1,0,0,0,0,0
15285,Matthew Worthington,Worthington,Midfielder,16,0,0,0,0,0
2316,Geremi,Geremi,Midfielder,3088,0,0,0,0,0
15212,Ben Johnson,Johnson,Midfielder,2248,0,0,0,0,0
15128,Luke Amos,Amos,Midfielder,2,0,0,0,0,0
3020,Hogan Ephraim,Ephraim,Midfielder,41,0,0,0,0,0
15199,Grady Diangana,Diangana,Midfielder,1842,0,0,0,0,0
15170,Marcus Forss,Forss,Forward,203,0,0,0,0,0
10477,Radamel Falcao,Falcao,Forward,1514,0,0,0,0,0
3017,Kyel Reid,Reid,Midfielder,10,0,0,0,0,0
3013,Yossi Benayoun,Benayoun,Midfielder,6786,0,0,0,0,0
2988,Lee Young-Pyo,Young-Pyo,Defender,1521,0,0,0,0,0
10494,Reece Grego-Cox,Grego-Cox,Midfielder,142,0,0,0,0,0
14903,Matthew Longstaff,Longstaff,Midfielder,949,0,0,0,0,0
2403,Keith Southern,Southern,Midfielder,1083,0,0,0,0,0
14800,Brahim Díaz,Diaz,Forward,50,0,0,0,0,0
2402,Brian McBride,McBride,Forward,1206,0,0,0,0,0
14771,Demeaco Duhaney,Duhaney,Defender,45,0,0,0,0,0
14758,Ben Woodburn,Woodburn,Midfielder,89,0,0,0,0,0
14753,Ovie Ejaria,Ejaria,Midfielder,6,0,0,0,0,0
13798,Alberto Paloschi,Paloschi,Forward,669,0,0,0,0,0
10518,Jefferson Montero,Montero,Midfielder,3301,0,0,0,0,0
10495,Brandon Comley,Comley,Midfielder,10,0,0,0,0,0
14723,Caoimhin Kelleher,Kelleher,Goalkeeper,360,0,0,0,0,0
10519,Kenji Gorré,Gorre,Midfielder,6,0,0,0,0,0
14716,Harvey Barnes,Barnes,Midfielder,7161,0,0,0,0,0
14706,Kiernan Dewsbury-Hall,Dewsbury-Hall,Midfielder,2105,0,0,0,0,0
10520,Modou Barrow,Barrow,Forward,2207,0,0,0,0,0
2419,Quincy Owusu-Abeyie,Owusu-Abeyie,Forward,357,0,0,0,0,0
10512,George Honeyman,Honeyman,Midfielder,271,0,0,0,0,0
10511,Ricardo Álvarez,Alvarez,Midfielder,494,0,0,0,0,0
10510,Thomas Robson,Robson,Defender,90,0,0,0,0,0
10507,Oliver Shenton,Shenton,Midfielder,1,0,0,0,0,0
10506,Dionatan Teixeira,Teixeira,Defender,49,0,0,0,0,0
10503,Ryan Seager,Seager,Forward,1,0,0,0,0,0
14801,Jadon Sancho,Sancho,Forward,1902,0,0,0,0,0
14804,Tyrese Campbell,Campbell,Forward,75,0,0,0,0,0
14805,Phil Foden,Foden,Midfielder,5012,0,0,0,0,0
14807,Lukas Nmecha,Nmecha,Forward,14,0,0,0,0,0
14822,Demetri Mitchell,Mitchell,Defender,90,0,0,0,0,0
2391,Sherjill MacDonald,MacDonald,Forward,110,0,0,0,0,0
14829,Jimmy Dunne,Dunne,Defender,270,0,0,0,0,0
14830,Angel Gomes,Gomes,Midfielder,46,0,0,0,0,0
10502,Graziano Pellè,Pelle,Forward,5457,0,0,0,0,0
10501,Jake Hesketh,Hesketh,Midfielder,52,0,0,0,0,0
10499,Eljero Elia,Elia,Forward,787,0,0,0,0,0
13799,Éder,Eder,Forward,269,0,0,0,0,0
13718,Juanmi,Juanmi,Forward,161,0,0,0,0,0
2532,Peter Ramage,Ramage,Defender,58,0,0,0,0,0
12735,Grzegorz Krychowiak,Krychowiak,Midfielder,1642,0,0,0,0,0
12854,Matteo Darmian,Darmian,Defender,4151,0,0,0,0,0
11146,Jake Clarke-Salter,Clarke-Salter,Defender,16,0,0,0,0,0
12847,Pontus Jansson,Jansson,Defender,3322,0,0,0,0,0
2778,Dean Ashton,Ashton,Forward,2245,0,0,0,0,0
12815,Max-Alain Gradel,Gradel,Midfielder,1024,0,0,0,0,0
11147,Charly Musonda,Musonda,Midfielder,35,0,0,0,0,0
2789,Diomansy Kamara,Kamara,Forward,3027,0,0,0,0,0
12463,Jérémy Pied,Pied,Defender,306,0,0,0,0,0
12703,Steven Bergwijn,Bergwijn,Forward,2463,0,0,0,0,0
12639,Manolo Gabbiadini,Gabbiadini,Forward,2275,0,0,0,0,0
2795,Jelle Van Damme,Damme,Defender,278,0,0,0,0,0
12576,Djibril Sidibé,Sidibe,Defender,1820,0,0,0,0,0
2797,Leon Best,Best,Forward,1915,0,0,0,0,0
12520,Mateo Kovacic,Kovacic,Midfielder,7191,0,0,0,0,0
2913,Antonio Barragán,Barragan,Defender,2196,0,0,0,0,0
2765,Adam Drury,Drury,Defender,907,0,0,0,0,0
12946,Aleix García,Garcia,Midfielder,75,0,0,0,0,0
2761,Joe Lewis,Lewis,Goalkeeper,90,0,0,0,0,0
12983,Adama Diomande,Diomande,Forward,1169,0,0,0,0,0
2759,Darren Ward,Ward,Goalkeeper,270,0,0,0,0,0
2746,Sylvan Ebanks-Blake,Ebanks-Blake,Forward,3485,0,0,0,0,0
13125,José Crespo,Crespo,Defender,90,0,0,0,0,0
2917,Jack Hobbs,Hobbs,Defender,129,0,0,0,0,0
11074,Sandro Ramírez,Ramirez,Forward,276,0,0,0,0,0
13129,Jordan Lyden,Lyden,Midfielder,152,0,0,0,0,0
13130,Keinan Davis,Davis,Forward,815,0,0,0,0,0
2921,Mohamed Sissoko,Sissoko,Midfielder,553,0,0,0,0,0
13131,Kevin Toner,Toner,Defender,315,0,0,0,0,0
13145,Ashley Fletcher,Fletcher,Forward,382,0,0,0,0,0
11070,Jesús Gámez,Gamez,Defender,97,0,0,0,0,0
2737,Gerard Piqué,Pique,Defender,477,0,0,0,0,0
2799,Radek Cerny,Cerny,Goalkeeper,1620,0,0,0,0,0
2908,Robert Milsom,Milsom,Midfielder,10,0,0,0,0,0
15558,Moritz Leitner,Leitner,Midfielder,684,0,0,0,0,0
2843,Carlos Vela,Vela,Forward,1017,0,0,0,0,0
2841,Fabrice Muamba,Muamba,Midfielder,12919,0,0,0,0,0
2842,Anthony Stokes,Stokes,Forward,779,0,0,0,0,0
2901,Andy van der Meijde,Meijde,Midfielder,9,0,0,0,0,0
2897,Nuno Valente,Valente,Defender,802,0,0,0,0,0
11366,André Carrillo,Carrillo,Midfielder,1536,0,0,0,0,0
11364,Islam Slimani,Slimani,Forward,1668,0,0,0,0,0
11362,Daniel Podence,Podence,Midfielder,3444,0,0,0,0,0
2808,Pedro Mendes,Mendes,Midfielder,1219,0,0,0,0,0
2892,Scott Sinclair,Sinclair,Forward,6055,0,0,0,0,0
11357,Adrien Silva,Silva,Midfielder,849,0,0,0,0,0
2870,Shefki Kuqi,Kuqi,Forward,426,0,0,0,0,0
11355,João Mário,Mario,Midfielder,1027,0,0,0,0,0
11300,James Rodríguez,Rodriguez,Midfielder,1775,0,0,0,0,0
2862,Sone Aluko,Aluko,Forward,2177,0,0,0,0,0
2838,Aliaksandr Hleb,Hleb,Midfielder,3532,0,0,0,0,0
11961,Lynden Gooch,Gooch,Midfielder,364,0,0,0,0,0
12114,Cenk Tosun,Tosun,Forward,2557,0,0,0,0,0
2836,Matthew Connolly,Connolly,Defender,758,0,0,0,0,0
2830,Robert Hulse,Hulse,Forward,70,0,0,0,0,0
2819,Robert Earnshaw,Earnshaw,Forward,926,0,0,0,0,0
2818,Tomasz Kuszczak,Kuszczak,Goalkeeper,2262,0,0,0,0,0
2817,Luke Daniels,Daniels,Goalkeeper,12,0,0,0,0,0
11224,Robin Olsen,Olsen,Goalkeeper,720,0,0,0,0,0
2907,Philippe Christanval,Christanval,Defender,15,0,0,0,0,0
11191,Eric Choupo-Moting,Choupo-Moting,Forward,2247,0,0,0,0,0
12212,José Izquierdo,Izquierdo,Forward,2789,0,0,0,0,0
12215,Obbi Oularé,Oulare,Forward,5,0,0,0,0,0
12299,Léo Bonatini,Bonatini,Forward,130,0,0,0,0,0
2812,Andy Reid,Reid,Midfielder,4645,0,0,0,0,0
12316,Naby Keïta,Keita,Midfielder,3904,0,0,0,0,0
12322,Takumi Minamino,Minamino,Forward,1426,0,0,0,0,0
13195,Sam Surridge,Surridge,Forward,36,0,0,0,0,0
13229,Uwe Hünemeier,Hunemeier,Defender,17,0,0,0,0,0
2541,Linvoy Primus,Primus,Defender,1,0,0,0,0,0
13558,Donald Love,Love,Defender,660,0,0,0,0,0
13563,James Weir,Weir,Midfielder,1,0,0,0,0,0
2948,Fábio Rochemback,Rochemback,Midfielder,1986,0,0,0,0,0
2947,Josh Walker,Walker,Midfielder,267,0,0,0,0,0
2570,Carl Ikeme,Ikeme,Goalkeeper,38,0,0,0,0,0
13560,Cameron Borthwick-Jackson,Borthwick-Jackson,Defender,692,0,0,0,0,0
2579,Michael Kightly,Kightly,Midfielder,4028,0,0,0,0,0
10800,Emilio Nsue,Nsue,Midfielder,322,0,0,0,0,0
10883,Tariqe Fosu-Henry,Fosu-Henry,Midfielder,16,0,0,0,0,0
13556,Joel Pereira,Pereira,Goalkeeper,90,0,0,0,0,0
2943,Lee Martin,Martin,Midfielder,90,0,0,0,0,0
13555,Sergio Romero,Romero,Goalkeeper,630,0,0,0,0,0
2588,Seol Ki-Hyeon,Ki-Hyeon,Midfielder,692,0,0,0,0,0
13552,Manu García,Garcia,Midfielder,10,0,0,0,0,0
2589,Kenny Miller,Miller,Forward,2574,0,0,0,0,0
2559,Martin Cranie,Cranie,Defender,233,0,0,0,0,0
13573,Cristhian Stuani,Stuani,Forward,1361,0,0,0,0,0
2558,Fitz Hall,Hall,Defender,962,0,0,0,0,0
10761,Gaetano Berardi,Berardi,Defender,114,0,0,0,0,0
13706,David Brooks,Brooks,Midfielder,2787,0,0,0,0,0
10734,Emerson Hyndman,Hyndman,Midfielder,96,0,0,0,0,0
2554,Vincent Pericard,Pericard,Forward,119,0,0,0,0,0
10727,Marek Rodák,Rodak,Goalkeeper,180,0,0,0,0,0
10654,Karlan Grant,Grant,Forward,2006,0,0,0,0,0
13777,Jakob Haugaard,Haugaard,Goalkeeper,405,0,0,0,0,0
13791,Lamine Koné,Kone,Defender,3860,0,0,0,0,0
13793,Wahbi Khazri,Khazri,Forward,1915,0,0,0,0,0
2950,Tom Craddock,Craddock,Forward,93,0,0,0,0,0
10634,Tom James,James,Defender,1,0,0,0,0,0
13794,Rees Greenwood,Greenwood,Midfielder,52,0,0,0,0,0
2955,Emre,Emre,Midfielder,590,0,0,0,0,0
10604,Jota,Jota,Midfielder,332,0,0,0,0,0
10881,Jack Stacey,Stacey,Defender,1541,0,0,0,0,0
2940,Park Ji-Sung,Ji-Sung,Midfielder,6683,0,0,0,0,0
13234,Tomer Hemed,Hemed,Forward,848,0,0,0,0,0
11004,Kyle Lafferty,Lafferty,Forward,13,0,0,0,0,0
13285,Kenedy,Kenedy,Forward,3072,0,0,0,0,0
13284,Alexandre Pato,Pato,Forward,131,0,0,0,0,0
13283,Kasey Palmer,Palmer,Midfielder,169,0,0,0,0,0
2929,Albert Riera,Riera,Midfielder,2548,0,0,0,0,0
13281,Fikayo Tomori,Tomori,Defender,1368,0,0,0,0,0
2683,Tom Soares,Soares,Midfielder,413,0,0,0,0,0
11013,Connor Randall,Randall,Defender,163,0,0,0,0,0
2590,Henri Camara,Camara,Forward,888,0,0,0,0,0
11031,Donny van de Beek,Beek,Midfielder,1065,0,0,0,0,0
11033,Anwar El Ghazi,Ghazi,Midfielder,4067,0,0,0,0,0
13278,Ademola Lookman,Lookman,Forward,5252,0,0,0,0,0
11034,Richairo Zivkovic,Zivkovic,Forward,107,0,0,0,0,0
2707,James Vaughan,Vaughan,Forward,541,0,0,0,0,0
13240,Jonathan Kodjia,Kodjia,Forward,112,0,0,0,0,0
2930,Georgios Samaras,Samaras,Forward,321,0,0,0,0,0
13340,Luke Dreher,Dreher,Midfielder,1,0,0,0,0,0
2931,Ishmael Miller,Miller,Forward,1134,0,0,0,0,0
10957,Odion Ighalo,Ighalo,Forward,4543,0,0,0,0,0
2668,Mikele Leigertwood,Leigertwood,Midfielder,2646,0,0,0,0,0
2654,Paulo Ferreira,Ferreira,Defender,3786,0,0,0,0,0
13388,Callum Connolly,Connolly,Defender,36,0,0,0,0,0
10953,Juan Carlos Paredes,Paredes,Defender,766,0,0,0,0,0
2643,Radhi Jaidi,Jaidi,Defender,1620,0,0,0,0,0
2637,Aaron Mokoena,Mokoena,Midfielder,3326,0,0,0,0,0
10952,Miguel Layún,Layun,Defender,132,0,0,0,0,0
13485,Bailey Peacock-Farrell,Peacock-Farrell,Goalkeeper,360,0,0,0,0,0
2625,Mehdi Nafti,Nafti,Midfielder,1757,0,0,0,0,0
2937,Richard Eckersley,Eckersley,Defender,49,0,0,0,0,0
13494,Shinji Okazaki,Okazaki,Forward,5240,0,0,0,0,0
13510,Pedro Chirivella,Chirivella,Midfielder,45,0,0,0,0,0
2593,Leon Clarke,Clarke,Forward,33,0,0,0,0,0
15549,Frédéric Guilbert,Guilbert,Defender,2041,0,0,0,0,0
4128,Danny Wilson,Wilson,Defender,155,0,0,0,0,0
15559,Christian Pulisic,Pulisic,Midfielder,4748,0,0,0,0,0
42331,Christian Nørgaard,Norgaard,Midfielder,3059,0,0,0,0,0
49477,Finley Stevens,Stevens,Midfielder,14,0,0,0,0,0
49316,Dejan Kulusevski,Kulusevski,Midfielder,1265,0,0,0,0,0
49293,Cole Palmer,Palmer,Midfielder,122,0,0,0,0,0
49270,James McAtee,McAtee,Midfielder,18,0,0,0,0,0
49259,Anthony Elanga,Elanga,Forward,1370,0,0,0,0,0
43856,Troy Parrott,Parrott,Forward,6,0,0,0,0,0
43098,Ferran Torres,Torres,Forward,1610,0,0,0,0,0
43087,Peter Etebo,Etebo,Midfielder,397,0,0,0,0,0
40320,Percy Tau,Tau,Forward,102,0,0,0,0,0
25071,Pierre Lees-Melou,Lees-Melou,Midfielder,2270,0,0,0,0,0
1370,Marc Edworthy,Edworthy,Defender,660,0,0,0,0,0
1382,Marcus Bent,Bent,Forward,2347,0,0,0,0,0
35781,Allan Tchaptchet,Tchaptchet,Defender,12,0,0,0,0,0
35741,Tony Springett,Springett,Midfielder,141,0,0,0,0,0
33185,Harvey Elliott,Elliott,Midfielder,371,0,0,0,0,0
33135,Jack Harrison,Harrison,Midfielder,5503,0,0,0,0,0
1401,John Oster,Oster,Midfielder,1021,0,0,0,0,0
33067,Dennis Srbeny,Srbeny,Forward,41,0,0,0,0,0
1309,Darius Vassell,Vassell,Forward,2226,0,0,0,0,0
49495,Valentino Livramento,Livramento,Defender,2203,0,0,0,0,0
49501,Lewis Bate,Bate,Midfielder,147,0,0,0,0,0
49504,Jesurun Rak-Sakyi,Rak-Sakyi,Midfielder,81,0,0,0,0,0
50960,Ignacio Pussetto,Pussetto,Forward,67,0,0,0,0,0
50857,Gedson Fernandes,Fernandes,Midfielder,62,0,0,0,0,0
1135,Nicolas Anelka,Anelka,Forward,11829,0,0,0,0,0
50501,Carlos Vinícius,Vinicius,Forward,305,0,0,0,0,0
50247,Boubakary Soumaré,Soumare,Midfielder,1100,0,0,0,0,0
1193,Kasey Keller,Keller,Goalkeeper,1170,0,0,0,0,0
50230,Andi Zeqiri,Zeqiri,Forward,165,0,0,0,0,0
1205,Patrik Berger,Berger,Midfielder,167,0,0,0,0,0
1208,Michael Owen,Owen,Forward,5077,0,0,0,0,0
1215,Jonathan Macken,Macken,Forward,41,0,0,0,0,0
49956,Antonio Barreca,Barreca,Defender,4,0,0,0,0,0
1295,Stuart Taylor,Taylor,Goalkeeper,653,0,0,0,0,0
49796,Ismaïla Sarr,Sarr,Forward,3892,0,0,0,0,0
49761,Sébastien Haller,Haller,Forward,3198,0,0,0,0,0
49726,Mathias Jensen,Jensen,Midfielder,1600,0,0,0,0,0
49716,Rúnar Rúnarsson,Runarsson,Goalkeeper,16,0,0,0,0,0
1302,Richard Hughes,Hughes,Midfielder,2906,0,0,0,0,0
33066,Onel Hernández,Hernandez,Midfielder,1381,0,0,0,0,0
1423,Danny Murphy,Murphy,Midfielder,13830,0,0,0,0,0
1429,Jonathan Greening,Greening,Midfielder,4999,0,0,0,0,0
26977,Josh Martin,Martin,Midfielder,32,0,0,0,0,0
1571,Djimi Traore,Traore,Defender,136,0,0,0,0,0
1595,Dietmar Hamann,Hamann,Midfielder,2679,0,0,0,0,0
1597,Nolberto Solano,Solano,Midfielder,1286,0,0,0,0,0
1620,Garry Monk,Monk,Defender,2186,0,0,0,0,0
25435,Oskar Buur,Buur,Defender,22,0,0,0,0,0
25329,Tanguy Ndombele,Ndombele,Midfielder,3599,0,0,0,0,0
25313,Davide Zappacosta,Zappacosta,Defender,1220,0,0,0,0,0
25312,Nikola Vlasic,Vlasic,Midfielder,1129,0,0,0,0,0
1633,Jimmy Bullard,Bullard,Midfielder,4033,0,0,0,0,0
1651,Sylvinho,Sylvinho,Defender,485,0,0,0,0,0
25292,Dimitri Foulquier,Foulquier,Defender,58,0,0,0,0,0
25281,Cameron Archer,Archer,Forward,24,0,0,0,0,0
25266,Mason Greenwood,Greenwood,Forward,4529,0,0,0,0,0
25246,Pablo Fornals,Fornals,Midfielder,7557,0,0,0,0,0
25203,Lukas Rupp,Rupp,Midfielder,1461,0,0,0,0,0
25191,Bruno Jordão,Jordao,Midfielder,6,0,0,0,0,0
25094,Saman Ghoddos,Ghoddos,Forward,528,0,0,0,0,0
1560,Olivier Dacourt,Dacourt,Midfielder,142,0,0,0,0,0
27277,Marc Cucurella,Cucurella,Defender,3092,0,0,0,0,0
32995,Jordan Thomas,Thomas,Defender,1,0,0,0,0,0
1554,Steve Simonsen,Simonsen,Goalkeeper,500,0,0,0,0,0
32989,Michael Olise,Olise,Midfielder,1137,0,0,0,0,0
32936,Fousseni Diabaté,Diabate,Forward,638,0,0,0,0,0
1432,Erik Nevland,Nevland,Forward,1845,0,0,0,0,0
32838,Moritz Bauer,Bauer,Defender,1308,0,0,0,0,0
32700,Przemyslaw Placheta,Placheta,Midfielder,505,0,0,0,0,0
1449,Richard Cresswell,Cresswell,Forward,1472,0,0,0,0,0
1497,Freddie Ljungberg,Ljungberg,Midfielder,1856,0,0,0,0,0
32298,Edo Kayembe,Kayembe,Midfielder,799,0,0,0,0,0
32289,Fábio Carvalho,Carvalho,Midfielder,255,0,0,0,0,0
1502,Kanu,Kanu,Forward,2624,0,0,0,0,0
31936,Iliman Ndiaye,Ndiaye,Midfielder,11,0,0,0,0,0
1538,Mikael Forssell,Forssell,Forward,1693,0,0,0,0,0
31883,Harrison Ashby,Ashby,Defender,6,0,0,0,0,0
1542,Gary McSheffrey,McSheffrey,Forward,2154,0,0,0,0,0
31670,Indiana Vassilev,Vassilev,Midfielder,47,0,0,0,0,0
31442,Armando Broja,Broja,Forward,1982,0,0,0,0,0
30534,Daniel Chesters,Chesters,Midfielder,1,0,0,0,0,0
51209,Joshua Sargent,Sargent,Forward,1578,0,0,0,0,0
51226,Nathan Young-Coombes,Young-Coombes,Forward,3,0,0,0,0,0
51238,Caleb Watts,Watts,Midfielder,36,0,0,0,0,0
70228,Kaide Gordon,Gordon,Forward,8,0,0,0,0,0
69617,Sonny Perkins,Perkins,Midfielder,3,0,0,0,0,0
69288,Stuart McKinstry,McKinstry,Midfielder,3,0,0,0,0,0
69286,Charlie Cresswell,Cresswell,Defender,139,0,0,0,0,0
69176,Amad Diallo,Diallo,Forward,167,0,0,0,0,0
68987,Alejandro Garnacho,Garnacho,Midfielder,12,0,0,0,0,0
68857,Jeremy Sarmiento,Sarmiento,Forward,45,0,0,0,0,0
68593,Hannibal Mejbri,Mejbri,Midfielder,76,0,0,0,0,0
67899,Reda Khadra,Khadra,Midfielder,4,0,0,0,0,0
67704,Christos Tzolis,Tzolis,Forward,327,0,0,0,0,0
67634,Vitinha,Vitinha,Midfielder,513,0,0,0,0,0
67454,Trincão,Trincao,Forward,1339,0,0,0,0,0
67198,Lewis Richardson,Richardson,Forward,3,0,0,0,0,0
67196,Alex Král,Kral,Midfielder,1,0,0,0,0,0
66670,Fábio Silva,Silva,Forward,1918,0,0,0,0,0
66669,Luis Díaz,Diaz,Forward,960,0,0,0,0,0
66647,Mads Bidstrup,Bidstrup,Midfielder,37,0,0,0,0,0
569,Nick Barmby,Barmby,Midfielder,1851,0,0,0,0,0
70216,Isaac Price,Price,Forward,12,0,0,0,0,0
321,Gary Neville,Neville,Defender,2634,0,0,0,0,0
66538,Tim Iroegbunam,Iroegbunam,Midfielder,91,0,0,0,0,0
71590,Evan Ferguson,Ferguson,Forward,22,0,0,0,0,0
120096,Kayky,Kayky,Forward,6,0,0,0,0,0
117497,Yoane Wissa,Wissa,Midfielder,1273,0,0,0,0,0
115169,Takehiro Tomiyasu,Tomiyasu,Defender,1682,0,0,0,0,0
112246,Leo Fuhr Hjelde,Hjelde,Defender,148,0,0,0,0,0
112203,Moisés Caicedo,Caicedo,Midfielder,664,0,0,0,0,0
111987,Daniel Jebbison,Jebbison,Forward,284,0,0,0,0,0
108751,Jakub Moder,Moder,Midfielder,2350,0,0,0,0,0
108612,Frank Onyeka,Onyeka,Midfielder,1050,0,0,0,0,0
104260,Niall Huggins,Huggins,Defender,37,0,0,0,0,0
92635,Toti,Toti,Defender,360,0,0,0,0,0
83496,Antwoine Hackford,Hackford,Forward,10,0,0,0,0,0
239,Gary Speed,Speed,Midfielder,972,0,0,0,0,0
76258,Niels Nkounkou,Nkounkou,Defender,81,0,0,0,0,0
75991,Joel Mumbongo,Mumbongo,Forward,37,0,0,0,0,0
74761,Bruno Guimarães,Guimaraes,Midfielder,1033,0,0,0,0,0
72371,João Pedro,Pedro,Forward,1660,0,0,0,0,0
277,Robbie Fowler,Fowler,Forward,114,0,0,0,0,0
66570,Dane Scarlett,Scarlett,Forward,4,0,0,0,0,0
706,Robbie Savage,Savage,Midfielder,2161,0,0,0,0,0
51416,Ørjan Nyland,Nyland,Goalkeeper,537,0,0,0,0,0
53151,Brandon Pierrick,Pierrick,Forward,13,0,0,0,0,0
52951,Ki-Jana Hoever,Hoever,Midfielder,881,0,0,0,0,0
1118,Jason Euell,Euell,Forward,105,0,0,0,0,0
52613,Liam McCarron,McCarron,Midfielder,9,0,0,0,0,0
51813,Liam Delap,Delap,Forward,48,0,0,0,0,0
1133,Julian Gray,Gray,Midfielder,4,0,0,0,0,0
51754,Joe Gelhardt,Gelhardt,Forward,738,0,0,0,0,0
51690,CJ Egan-Riley,Egan-Riley,Defender,3,0,0,0,0,0
51648,Chem Campbell,Campbell,Midfielder,12,0,0,0,0,0
51593,Elliot Anderson,Anderson,Midfielder,3,0,0,0,0,0
51582,William Fish,Fish,Defender,1,0,0,0,0,0
51574,Tyler Morton,Morton,Midfielder,66,0,0,0,0,0
51553,Kasey McAteer,McAteer,Midfielder,2,0,0,0,0,0
51511,Lewis Dobbin,Dobbin,Forward,30,0,0,0,0,0
51510,Tyler Onyango,Onyango,Midfielder,27,0,0,0,0,0
51505,Max Thompson,Thompson,Forward,2,0,0,0,0,0
51454,Leif Davis,Davis,Defender,31,0,0,0,0,0
51423,John McGinn,McGinn,Midfielder,8738,0,0,0,0,0
53085,Andrew Omobamidele,Omobamidele,Defender,381,0,0,0,0,0
53182,Theo Corbeanu,Corbeanu,Forward,8,0,0,0,0,0
66360,Bryan Mbeumo,Mbeumo,Midfielder,2915,0,0,0,0,0
54056,Femi Seriki,Seriki,Defender,1,0,0,0,0,0
725,Andrew Cole,Cole,Forward,236,0,0,0,0,0
868,Glen Little,Little,Midfielder,345,0,0,0,0,0
929,Danny Mills,Mills,Defender,122,0,0,0,0,0
65961,Crysencio Summerville,Summerville,Midfielder,126,0,0,0,0,0
65782,Jonathan Rowe,Rowe,Forward,210,0,0,0,0,0
64519,Jaden Philogene-Bidace,Philogene-Bidace,Midfielder,5,0,0,0,0,0
64147,Matty Daly,Daly,Midfielder,73,0,0,0,0,0
64142,Shola Shoretire,Shoretire,Forward,24,0,0,0,0,0
64140,Carney Chukwuemeka,Chukwuemeka,Midfielder,313,0,0,0,0,0
63654,Emerson Royal,Royal,Defender,2289,0,0,0,0,0
63633,Alexis Mac Allister,Allister,Midfielder,3584,0,0,0,0,0
55700,Bryan Gil,Gil,Forward,86,0,0,0,0,0
1045,Ian Harte,Harte,Defender,1667,0,0,0,0,0
1049,Harry Kewell,Kewell,Midfielder,608,0,0,0,0,0
54392,Zack Steffen,Steffen,Goalkeeper,180,0,0,0,0,0
1095,Dejan Stefanovic,Stefanovic,Defender,1170,0,0,0,0,0
54144,Imrân Louza,Louza,Midfielder,1419,0,0,0,0,0
25089,Ken Sema,Sema,Midfielder,1600,0,0,0,0,0
1658,Jay Bothroyd,Bothroyd,Forward,1340,0,0,0,0,0
15580,Wesley Moraes,Moraes,Forward,1806,0,0,0,0,0
19758,Diogo Jota,Jota,Forward,8150,0,0,0,0,0
19925,Ellis Simms,Simms,Forward,62,0,0,0,0,0
19890,Lewis Brunt,Brunt,Midfielder,23,0,0,0,0,0
19888,Jacob Ramsey,Ramsey,Midfielder,3093,0,0,0,0,0
19871,Folarin Balogun,Balogun,Forward,70,0,0,0,0,0
19869,Dominic Thompson,Thompson,Defender,148,0,0,0,0,0
19859,Jonathan Calleri,Calleri,Forward,537,0,0,0,0,0
19851,Giovani Lo Celso,Celso,Midfielder,2669,0,0,0,0,0
19778,Mikel Merino,Merino,Midfielder,1343,0,0,0,0,0
19752,Akin Famewo,Famewo,Defender,1,0,0,0,0,0
24994,Patson Daka,Daka,Forward,1161,0,0,0,0,0
2111,Milan Baros,Baros,Forward,620,0,0,0,0,0
19678,Domingos Quina,Quina,Midfielder,352,0,0,0,0,0
19677,Brandon Mason,Mason,Defender,112,0,0,0,0,0
19675,Michael McGovern,McGovern,Goalkeeper,158,0,0,0,0,0
19673,Ramadan Sobhi,Sobhi,Midfielder,2157,0,0,0,0,0
2126,Laurent Robert,Robert,Midfielder,181,0,0,0,0,0
19618,Isaac Success,Success,Forward,1609,0,0,0,0,0
2128,Michael Chopra,Chopra,Forward,2208,0,0,0,0,0
19928,Taylor Richards,Richards,Midfielder,23,0,0,0,0,0
19929,Ian Poveda-Ocampo,Poveda-Ocampo,Forward,344,0,0,0,0,0
19967,Kelland Watts,Watts,Defender,16,0,0,0,0,0
20048,Josh Maja,Maja,Forward,809,0,0,0,0,0
20607,Joelinton,Joelinton,Forward,7242,0,0,0,0,0
2009,David Bentley,Bentley,Midfielder,7057,0,0,0,0,0
20499,Malang Sarr,Sarr,Defender,546,0,0,0,0,0
20490,Mbwana Samatta,Samatta,Forward,946,0,0,0,0,0
20489,Leon Bailey,Bailey,Forward,756,0,0,0,0,0
20337,Hwang Hee-Chan,Hee-Chan,Forward,1819,0,0,0,0,0
2031,Nicky Hunt,Hunt,Defender,1102,0,0,0,0,0
20261,Wout Weghorst,Weghorst,Forward,1457,0,0,0,0,0
20196,Yoshinori Muto,Muto,Forward,724,0,0,0,0,0
20187,Jean-Philippe Gbamin,Gbamin,Midfielder,212,0,0,0,0,0
20178,Neeskens Kebano,Kebano,Midfielder,220,0,0,0,0,0
20171,Rúben Vinagre,Vinagre,Defender,1524,0,0,0,0,0
20113,Kristoffer Ajer,Ajer,Defender,1987,0,0,0,0,0
20101,Rekeem Harper,Harper,Midfielder,50,0,0,0,0,0
2074,Mark Hudson,Hudson,Defender,147,0,0,0,0,0
20095,Aiden O'Neill,O'Neill,Midfielder,83,0,0,0,0,0
20064,Jeremy Ngakia,Ngakia,Defender,1341,0,0,0,0,0
2133,Brett Ormerod,Ormerod,Forward,702,0,0,0,0,0
19606,Floyd Ayité,Ayite,Forward,468,0,0,0,0,0
3034,Gary Teale,Teale,Midfielder,919,0,0,0,0,0
16592,Josh Harrop,Harrop,Midfielder,90,0,0,0,0,0
16524,Arnaut Danjuma,Danjuma,Forward,628,0,0,0,0,0
2204,Paul Gallagher,Gallagher,Midfielder,15,0,0,0,0,0
2208,Ivan Campo,Campo,Midfielder,2063,0,0,0,0,0
2220,Nathan Ashton,Ashton,Defender,90,0,0,0,0,0
16234,Ezequiel Schelotto,Schelotto,Defender,1677,0,0,0,0,0
2258,Frazer Richardson,Richardson,Defender,167,0,0,0,0,0
16088,Dodi Lukébakio,Lukebakio,Forward,15,0,0,0,0,0
16006,Konstantinos Tsimikas,Tsimikas,Defender,879,0,0,0,0,0
2283,Alou Diarra,Diarra,Midfielder,251,0,0,0,0,0
15989,Guido Carrillo,Carrillo,Forward,452,0,0,0,0,0
15967,Mohamed Elyounoussi,Elyounoussi,Midfielder,2832,0,0,0,0,0
15938,Georges-Kévin Nkoudou,Nkoudou,Midfielder,280,0,0,0,0,0
15791,Ozan Tufan,Tufan,Midfielder,338,0,0,0,0,0
15759,Edimilson Fernandes,Fernandes,Midfielder,1831,0,0,0,0,0
2285,Salif Diao,Diao,Midfielder,2770,0,0,0,0,0
15685,Alexander Sørloth,Sorloth,Forward,533,0,0,0,0,0
2293,Paddy McCarthy,McCarthy,Midfielder,26,0,0,0,0,0
16550,Filip Lesniak,Lesniak,Midfielder,4,0,0,0,0,0
2201,Neil Danns,Danns,Midfielder,20,0,0,0,0,0
2168,Rob Edwards,Edwards,Defender,106,0,0,0,0,0
16622,Borja Bastón,Baston,Forward,563,0,0,0,0,0
2169,Ulises de la Cruz,Cruz,Defender,339,0,0,0,0,0
2171,Peter Whittingham,Whittingham,Midfielder,2661,0,0,0,0,0
2172,Keith Fahey,Fahey,Midfielder,3215,0,0,0,0,0
19599,Luis Hernández,Hernandez,Defender,326,0,0,0,0,0
19591,Dimitris Giannoulis,Giannoulis,Defender,1166,0,0,0,0,0
2173,Johannes Karl Gudjonsson,Gudjonsson,Midfielder,311,0,0,0,0,0
19564,Jesús Vallejo,Vallejo,Defender,162,0,0,0,0,0
16803,Emerson,Emerson,Defender,2057,0,0,0,0,0
2180,Michael Johnson,Johnson,Defender,191,0,0,0,0,0
16793,Kiko Casilla,Casilla,Goalkeeper,270,0,0,0,0,0
16788,Odsonne Édouard,Edouard,Forward,1567,0,0,0,0,0
16758,Maxwel Cornet,Cornet,Midfielder,1776,0,0,0,0,0
16747,Laurent Depoitre,Depoitre,Forward,2870,0,0,0,0,0
16719,Simone Zaza,Zaza,Forward,460,0,0,0,0,0
16646,Renato Sanches,Sanches,Midfielder,703,0,0,0,0,0
2187,Bryan Hughes,Hughes,Midfielder,124,0,0,0,0,0
2193,Stern John,John,Forward,31,0,0,0,0,0
20646,Isaac Mbenza,Mbenza,Forward,982,0,0,0,0,0
1948,Stuart Parnaby,Parnaby,Defender,1585,0,0,0,0,0
20723,Steven Alzate,Alzate,Forward,2485,0,0,0,0,0
23976,Nathan Ferguson,Ferguson,Defender,8,0,0,0,0,0
23903,Bali Mumba,Mumba,Defender,45,0,0,0,0,0
23841,James Garner,Garner,Midfielder,9,0,0,0,0,0
23834,Brandon Williams,Williams,Defender,3314,0,0,0,0,0
23820,Rafael Camacho,Camacho,Midfielder,1,0,0,0,0,0
23815,Curtis Jones,Jones,Midfielder,2155,0,0,0,0,0
23813,Rhys Williams,Williams,Defender,660,0,0,0,0,0
1740,Kieron Dyer,Dyer,Midfielder,1540,0,0,0,0,0
23797,Sidnei Tavares,Tavares,Midfielder,85,0,0,0,0,0
23796,Luke Thomas,Thomas,Defender,3149,0,0,0,0,0
23784,Thakgalo Leshabela,Leshabela,Midfielder,9,0,0,0,0,0
23747,Anthony Gordon,Gordon,Forward,2812,0,0,0,0,0
23702,Callum Hudson-Odoi,Hudson-Odoi,Forward,3292,0,0,0,0,0
23612,Cengiz Ünder,Under,Forward,274,0,0,0,0,0
23599,Timo Werner,Werner,Forward,3888,0,0,0,0,0
1768,Kevin Phillips,Phillips,Forward,976,0,0,0,0,0
23591,Bernardo,Bernardo,Defender,2632,0,0,0,0,0
23575,Filip Krovinovic,Krovinovic,Midfielder,544,0,0,0,0,0
23911,Sam Greenwood,Greenwood,Forward,232,0,0,0,0,0
23989,Luke Cundle,Cundle,Midfielder,180,0,0,0,0,0
1791,Heidar Helguson,Helguson,Forward,1453,0,0,0,0,0
23994,Owen Otasowie,Otasowie,Midfielder,187,0,0,0,0,0
24983,Vitalii Mykolenko,Mykolenko,Defender,1056,0,0,0,0,0
24811,Cody Drameh,Drameh,Defender,126,0,0,0,0,0
24797,Dwight McNeil,McNeil,Forward,11125,0,0,0,0,0
1659,Thierry Henry,Henry,Forward,94,0,0,0,0,0
24708,Faustino Anjorin,Anjorin,Midfielder,19,0,0,0,0,0
24704,Tyrese Francois,Francois,Midfielder,14,0,0,0,0,0
1672,Dean Windass,Windass,Forward,115,0,0,0,0,0
24641,Adam Idah,Idah,Forward,841,0,0,0,0,0
24637,Tommy Doyle,Doyle,Midfielder,15,0,0,0,0,0
24412,Tom Trybull,Trybull,Midfielder,1136,0,0,0,0,0
1715,Paul Rachubka,Rachubka,Goalkeeper,124,0,0,0,0,0
24253,Adama Diakhaby,Diakhaby,Forward,553,0,0,0,0,0
1724,David Healy,Healy,Forward,1536,0,0,0,0,0
1725,Danny Webber,Webber,Forward,460,0,0,0,0,0
24151,Xande Silva,Silva,Forward,17,0,0,0,0,0
24128,Milot Rashica,Rashica,Midfielder,2236,0,0,0,0,0
24001,Kayne Ramsay,Ramsay,Defender,180,0,0,0,0,0
23520,Loïc Damour,Damour,Midfielder,21,0,0,0,0,0
23199,Marco Stiepermann,Stiepermann,Forward,1187,0,0,0,0,0
1941,Alan Tate,Tate,Defender,326,0,0,0,0,0
21731,Kamil Grosicki,Grosicki,Midfielder,1065,0,0,0,0,0
21714,Samuel Kalu,Kalu,Forward,222,0,0,0,0,0
21677,Collin Quaner,Quaner,Forward,1309,0,0,0,0,0
21653,Aaron Connolly,Connolly,Forward,2206,0,0,0,0,0
21614,Sander Berge,Berge,Midfielder,2069,0,0,0,0,0
1886,Thomas Gravesen,Gravesen,Midfielder,173,0,0,0,0,0
1909,Mark Viduka,Viduka,Forward,2266,0,0,0,0,0
21532,Michael Obafemi,Obafemi,Forward,862,0,0,0,0,0
21495,Romain Perraud,Perraud,Defender,1625,0,0,0,0,0
21468,Andrew Eleftheriou,Eleftheriou,Defender,51,0,0,0,0,0
21413,Oliver Skipp,Skipp,Midfielder,1639,0,0,0,0,0
1919,Grégory Vignal,Vignal,Defender,501,0,0,0,0,0
20958,Moise Kean,Kean,Forward,849,0,0,0,0,0
20929,Ben Wilmot,Wilmot,Defender,26,0,0,0,0,0
20874,Jean-Philippe Mateta,Mateta,Forward,1365,0,0,0,0,0
20858,Tahith Chong,Chong,Forward,71,0,0,0,0,0
20789,Jonathan Benteke,Benteke,Forward,6,0,0,0,0,0
20750,Hakim Ziyech,Ziyech,Midfielder,2494,0,0,0,0,0
1870,Lee Grant,Grant,Goalkeeper,2790,0,0,0,0,0
21887,Conor Gallagher,Gallagher,Midfielder,5382,0,0,0,0,0
23194,Vitaly Janelt,Janelt,Midfielder,2307,0,0,0,0,0
21903,Dion Pereira,Pereira,Midfielder,23,0,0,0,0,0
23152,Kristoffer Klaesson,Klaesson,Goalkeeper,35,0,0,0,0,0
1799,Tommy Smith,Smith,Forward,1566,0,0,0,0,0
22952,Víctor Camarasa,Camarasa,Midfielder,2583,0,0,0,0,0
22870,Patrick Cutrone,Cutrone,Forward,318,0,0,0,0,0
1829,John Halls,Halls,Defender,7,0,0,0,0,0
22802,Rodrigo Bentancur,Bentancur,Midfielder,1365,0,0,0,0,0
22651,Marc Navarro,Navarro,Defender,85,0,0,0,0,0
22591,Abdelhamid Sabiri,Sabiri,Midfielder,267,0,0,0,0,0
1831,Lauren,Lauren,Defender,977,0,0,0,0,0
1835,Robert Pires,Pires,Midfielder,248,0,0,0,0,0
1840,Thomas Hitzlsperger,Hitzlsperger,Midfielder,1339,0,0,0,0,0
1848,Dean Kiely,Kiely,Goalkeeper,270,0,0,0,0,0
1866,Eidur Gudjohnsen,Gudjohnsen,Forward,855,0,0,0,0,0
22046,Callum Paterson,Paterson,Forward,1996,0,0,0,0,0
22043,Ethan Pinnock,Pinnock,Defender,2697,0,0,0,0,0
1868,Calum Davenport,Davenport,Defender,1316,0,0,0,0,0
21998,Pedro Neto,Neto,Forward,3951,0,0,0,0,0
2165,Gilberto Silva,Silva,Midfielder,1182,0,0,0,0,0
9650,Sam Gallagher,Gallagher,Forward,415,0,0,0,0,0
10471,José Ángel Pozo,Pozo,Midfielder,137,0,0,0,0,0
4579,Daniel Carriço,Carrico,Defender,85,0,0,0,0,0
3776,Jonathon Routledge,Routledge,Defender,1,0,0,0,0,0
4598,Dominic Samuel,Samuel,Forward,18,0,0,0,0,0
4593,Noel Hunt,Hunt,Forward,952,0,0,0,0,0
4592,Adam Le Fondre,Fondre,Forward,1492,0,0,0,0,0
3778,Amr Zaki,Zaki,Forward,2284,0,0,0,0,0
4586,Garath McCleary,McCleary,Midfielder,1572,0,0,0,0,0
4585,Jobi McAnuff,McAnuff,Midfielder,3274,0,0,0,0,0
4582,Michael Hector,Hector,Defender,264,0,0,0,0,0
3779,Callum McManaman,McManaman,Midfielder,1301,0,0,0,0,0
3823,Junior Hoilett,Hoilett,Midfielder,9863,0,0,0,0,0
3800,Gary Gardner,Gardner,Midfielder,623,0,0,0,0,0
4570,Esteban Granero,Granero,Midfielder,1663,0,0,0,0,0
3810,Míchel,Michel,Midfielder,305,0,0,0,0,0
3814,Christian Benitez,Benitez,Forward,1934,0,0,0,0,0
3816,Jay O'Shea,O'Shea,Midfielder,8,0,0,0,0,0
4562,Luciano Becchio,Becchio,Forward,222,0,0,0,0,0
4561,Josh Murphy,Murphy,Midfielder,1953,0,0,0,0,0
3817,Jake Kean,Kean,Goalkeeper,90,0,0,0,0,0
3774,Cho Won-Hee,Won-Hee,Midfielder,170,0,0,0,0,0
3772,David Di Michele,Michele,Forward,1901,0,0,0,0,0
3771,Zavon Hines,Hines,Forward,1001,0,0,0,0,0
3770,Diego Tristán,Tristan,Forward,727,0,0,0,0,0
4638,Maurice Edu,Edu,Midfielder,9,0,0,0,0,0
4637,Brek Shea,Shea,Defender,120,0,0,0,0,0
3749,Borja Valero,Valero,Midfielder,2302,0,0,0,0,0
3753,Craig Beattie,Beattie,Forward,148,0,0,0,0,0
4629,Emmanuel Mayuka,Mayuka,Forward,271,0,0,0,0,0
4627,Rickie Lambert,Lambert,Forward,7401,0,0,0,0,0
4624,Dominic Gape,Gape,Midfielder,1,0,0,0,0,0
4622,Steve De Ridder,Ridder,Midfielder,48,0,0,0,0,0
4621,Lloyd Isgrove,Isgrove,Midfielder,8,0,0,0,0,0
3759,Peter Kurucz,Kurucz,Goalkeeper,17,0,0,0,0,0
3760,Jordan Spence,Spence,Defender,204,0,0,0,0,0
3764,Wálter López,Lopez,Defender,19,0,0,0,0,0
4614,Dean Hammond,Hammond,Midfielder,781,0,0,0,0,0
3766,Junior Stanislas,Stanislas,Midfielder,8163,0,0,0,0,0
4611,Ben Reeves,Reeves,Midfielder,26,0,0,0,0,0
3767,Josh Payne,Payne,Midfielder,11,0,0,0,0,0
3769,Savio Nsereko,Nsereko,Forward,235,0,0,0,0,0
3822,Yildiray Bastürk,Basturk,Midfielder,45,0,0,0,0,0
4556,Lee Camp,Camp,Goalkeeper,222,0,0,0,0,0
3894,Tom Cairney,Cairney,Midfielder,3857,0,0,0,0,0
4503,Eden Hazard,Hazard,Forward,19452,0,0,0,0,0
3859,Jeffrey Bruma,Bruma,Defender,165,0,0,0,0,0
3860,Yuri Zhirkov,Zhirkov,Midfielder,1558,0,0,0,0,0
4513,Stanislav Manolev,Manolev,Defender,430,0,0,0,0,0
4511,Marcus Bettinelli,Bettinelli,Goalkeeper,630,0,0,0,0,0
4510,Steven Naismith,Naismith,Forward,6075,0,0,0,0,0
3868,Luke Garbutt,Garbutt,Defender,287,0,0,0,0,0
4506,Jiang Guangtai,Guangtai,Defender,328,0,0,0,0,0
3878,Hope Akpan,Akpan,Midfielder,469,0,0,0,0,0
4502,Marko Marin,Marin,Midfielder,143,0,0,0,0,0
4555,Adam Campbell,Campbell,Forward,22,0,0,0,0,0
4501,Oscar,Oscar,Midfielder,8699,0,0,0,0,0
3880,Conor McAleny,McAleny,Forward,15,0,0,0,0,0
3883,Alex Smith,Smith,Defender,1,0,0,0,0,0
3886,Bjørn Helge Riise,Riise,Midfielder,432,0,0,0,0,0
3889,Stefano Okaka,Okaka,Forward,1863,0,0,0,0,0
3890,David Elm,Elm,Forward,325,0,0,0,0,0
4491,Brett Holman,Holman,Forward,1428,0,0,0,0,0
4490,Yacouba Sylla,Sylla,Midfielder,1144,0,0,0,0,0
4517,Urby Emanuelson,Emanuelson,Midfielder,643,0,0,0,0,0
4518,Chris David,David,Midfielder,67,0,0,0,0,0
4519,Eyong Enoh,Enoh,Midfielder,693,0,0,0,0,0
4521,Mladen Petric,Petric,Forward,941,0,0,0,0,0
3824,Amine Linganzi,Linganzi,Midfielder,83,0,0,0,0,0
4552,Gaël Bigirimana,Bigirimana,Midfielder,408,0,0,0,0,0
3831,Danny Ward,Ward,Forward,456,0,0,0,0,0
3834,Diego Penny,Penny,Goalkeeper,75,0,0,0,0,0
4545,Massadio Haïdara,Haidara,Defender,2280,0,0,0,0,0
4542,Ángelo Henríquez,Henriquez,Forward,45,0,0,0,0,0
4540,Nick Powell,Powell,Midfielder,85,0,0,0,0,0
4538,Shinji Kagawa,Kagawa,Midfielder,2495,0,0,0,0,0
3851,Jay Rodriguez,Rodriguez,Forward,13436,0,0,0,0,0
4534,Javi García,Garcia,Midfielder,3023,0,0,0,0,0
3852,Martin Paterson,Paterson,Forward,1431,0,0,0,0,0
4531,Maicon,Maicon,Defender,516,0,0,0,0,0
4529,Jerome Sinclair,Sinclair,Forward,168,0,0,0,0,0
4527,Jordon Ibe,Ibe,Forward,5769,0,0,0,0,0
3853,Frédéric Nimani,Nimani,Forward,44,0,0,0,0,0
3854,Steven Thompson,Thompson,Forward,380,0,0,0,0,0
4522,Danny Ward,Ward,Goalkeeper,270,0,0,0,0,0
3748,Juan Carlos Menseguéz,Menseguez,Forward,345,0,0,0,0,0
4641,Kader Mangane,Mangane,Defender,19,0,0,0,0,0
3747,Filipe Andrade Teixeira,Teixeira,Midfielder,257,0,0,0,0,0
4740,Rudy Gestede,Gestede,Forward,2231,0,0,0,0,0
3677,Jonathan Franks,Franks,Midfielder,9,0,0,0,0,0
4762,José Campaña,Campana,Midfielder,311,0,0,0,0,0
3679,Marvin Emnes,Emnes,Forward,1083,0,0,0,0,0
3682,Ignacio González,Gonzalez,Midfielder,36,0,0,0,0,0
4751,Samuel Eto'o,Eto'o,Forward,2088,0,0,0,0,0
4750,André Schürrle,Schurrle,Midfielder,3406,0,0,0,0,0
4747,Marco van Ginkel,Ginkel,Midfielder,763,0,0,0,0,0
4743,Rhys Healey,Healey,Forward,63,0,0,0,0,0
4739,Andreas Cornelius,Cornelius,Forward,107,0,0,0,0,0
4647,Adam Mitchell,Mitchell,Midfielder,2,0,0,0,0,0
4737,Don Cowie,Cowie,Midfielder,960,0,0,0,0,0
3684,Haris Vuckic,Vuckic,Forward,178,0,0,0,0,0
4735,Craig Noone,Noone,Midfielder,1225,0,0,0,0,0
3688,Peter Løvenkrands,Lovenkrands,Forward,2309,0,0,0,0,0
4733,Gary Medel,Medel,Midfielder,2873,0,0,0,0,0
4732,Declan John,John,Defender,1487,0,0,0,0,0
4730,Kévin Théophile-Catherine,Theophile-Catherine,Defender,2356,0,0,0,0,0
4728,Ben Turner,Turner,Defender,2720,0,0,0,0,0
4764,Owen Garvan,Garvan,Midfielder,93,0,0,0,0,0
4765,Stuart O'Keefe,O'Keefe,Midfielder,474,0,0,0,0,0
4767,Jonathan Williams,Williams,Midfielder,223,0,0,0,0,0
4769,Hiram Boateng,Boateng,Midfielder,18,0,0,0,0,0
3655,Gláuber,Glauber,Defender,5,0,0,0,0,0
4800,Iago Aspas,Aspas,Forward,380,0,0,0,0,0
4799,Luis Alberto,Alberto,Midfielder,135,0,0,0,0,0
4794,Nick Proschwitz,Proschwitz,Forward,23,0,0,0,0,0
4792,Aaron McLean,McLean,Forward,6,0,0,0,0,0
3660,Vladimír Weiss,Weiss,Midfielder,404,0,0,0,0,0
4789,Gedo,Gedo,Midfielder,30,0,0,0,0,0
3661,Robinho,Robinho,Forward,3176,0,0,0,0,0
3662,Ron-Robert Zieler,Zieler,Goalkeeper,753,0,0,0,0,0
3663,Ben Amos,Amos,Goalkeeper,90,0,0,0,0,0
4784,Mesca,Mesca,Midfielder,18,0,0,0,0,0
4783,Derek Boateng,Boateng,Midfielder,155,0,0,0,0,0
3665,Fábio,Fabio,Defender,5024,0,0,0,0,0
4780,Elsad Zverotic,Zverotic,Defender,405,0,0,0,0,0
3668,Zoran Tosic,Tosic,Midfielder,15,0,0,0,0,0
4777,Gerard Deulofeu,Deulofeu,Forward,7356,0,0,0,0,0
3674,John Johnson,Johnson,Defender,36,0,0,0,0,0
3689,Nile Ranger,Ranger,Forward,568,0,0,0,0,0
3692,Xisco,Xisco,Forward,301,0,0,0,0,0
4725,Callum Robinson,Robinson,Forward,2285,0,0,0,0,0
4692,Elliot Lee,Lee,Forward,15,0,0,0,0,0
4681,Daniel Potts,Potts,Defender,110,0,0,0,0,0
3732,Ryan Allsop,Allsop,Goalkeeper,135,0,0,0,0,0
4675,Markus Rosenberg,Rosenberg,Forward,628,0,0,0,0,0
4674,Isaiah Brown,Brown,Midfielder,321,0,0,0,0,0
3733,Carl Hoefkens,Hoefkens,Defender,659,0,0,0,0,0
3735,Marek Cech,Cech,Defender,1556,0,0,0,0,0
4667,Lewis Holtby,Holtby,Midfielder,2027,0,0,0,0,0
3736,Pelé,Pele,Defender,143,0,0,0,0,0
4660,Itay Shechter,Shechter,Forward,621,0,0,0,0,0
4659,Michu,Michu,Forward,4306,0,0,0,0,0
3743,Robert Koren,Koren,Midfielder,4130,0,0,0,0,0
3745,Kim Do-Heon,Do-Heon,Midfielder,767,0,0,0,0,0
4655,Roland Lamah,Lamah,Midfielder,606,0,0,0,0,0
4654,Pablo Hernández,Hernandez,Midfielder,4049,0,0,0,0,0
4652,Dwight Tiendalli,Tiendalli,Defender,1891,0,0,0,0,0
3746,Graham Dorrans,Dorrans,Midfielder,9120,0,0,0,0,0
4648,Mikael Mandron,Mandron,Forward,24,0,0,0,0,0
4690,Modibo Maiga,Maiga,Forward,1442,0,0,0,0,0
4694,Robert Hall,Hall,Forward,12,0,0,0,0,0
4724,Libor Kozák,Kozak,Forward,1039,0,0,0,0,0
3729,Giovani dos Santos,Santos,Midfielder,336,0,0,0,0,0
4723,Nicklas Helenius,Helenius,Forward,49,0,0,0,0,0
4722,Aleksandar Tonev,Tonev,Midfielder,596,0,0,0,0,0
3697,Angelos Basinas,Basinas,Midfielder,999,0,0,0,0,0
3699,Theofanis Gekas,Gekas,Forward,1,0,0,0,0,0
3704,Carl Dickinson,Dickinson,Defender,266,0,0,0,0,0
4718,Yaya Sanogo,Sanogo,Forward,528,0,0,0,0,0
3708,Mamady Sidibe,Sidibe,Forward,2912,0,0,0,0,0
3716,Jordan Cook,Cook,Forward,27,0,0,0,0,0
4711,Sam Baldock,Baldock,Forward,30,0,0,0,0,0
4710,Nicky Maynard,Maynard,Forward,121,0,0,0,0,0
4706,Kevin Mbabu,Mbabu,Defender,144,0,0,0,0,0
4705,Nuri Sahin,Sahin,Midfielder,454,0,0,0,0,0
4701,Arouna Koné,Kone,Forward,5141,0,0,0,0,0
4700,Fraser Fyvie,Fyvie,Midfielder,21,0,0,0,0,0
4699,Roger Espinoza,Espinoza,Midfielder,605,0,0,0,0,0
4698,Eduard Campabadal,Campabadal,Defender,2,0,0,0,0,0
3728,Roman Pavlyuchenko,Pavlyuchenko,Forward,3925,0,0,0,0,0
3892,Steven Mouyokolo,Mouyokolo,Defender,1831,0,0,0,0,0
3896,Kamel Ghilas,Ghilas,Forward,582,0,0,0,0,0
3651,Nathan Eccleston,Eccleston,Forward,21,0,0,0,0,0
4237,Dekel Keinan,Keinan,Defender,395,0,0,0,0,0
4257,Derrick Williams,Williams,Defender,24,0,0,0,0,0
4256,Park Chu-Young,Chu-Young,Forward,6,0,0,0,0,0
4254,Joel Campbell,Campbell,Forward,926,0,0,0,0,0
4034,Li Ke,Ke,Defender,45,0,0,0,0,0
4036,Ryo Miyaichi,Miyaichi,Midfielder,746,0,0,0,0,0
4040,Benik Afobe,Afobe,Forward,2923,0,0,0,0,0
4042,Michael Bradley,Bradley,Midfielder,28,0,0,0,0,0
4045,Martin Jiranek,Jiranek,Defender,785,0,0,0,0,0
4227,Mauro Boselli,Boselli,Forward,624,0,0,0,0,0
4207,Ruud Boffin,Boffin,Goalkeeper,90,0,0,0,0,0
4053,Josh Morris,Morris,Midfielder,163,0,0,0,0,0
4054,Jermaine Jones,Jones,Midfielder,1296,0,0,0,0,0
4055,Jason Lowe,Lowe,Midfielder,2732,0,0,0,0,0
4219,Ronnie Stam,Stam,Defender,3815,0,0,0,0,0
4056,Mauro Formica,Formica,Midfielder,2172,0,0,0,0,0
4214,Victor Obinna,Obinna,Forward,1571,0,0,0,0,0
4059,Rubén Rochina,Rochina,Midfielder,936,0,0,0,0,0
4212,Pablo Barrera,Barrera,Forward,744,0,0,0,0,0
4029,Elliott Bennett,Bennett,Midfielder,3052,0,0,0,0,0
4259,Samir Carruthers,Carruthers,Midfielder,20,0,0,0,0,0
4025,Luis Jiménez,Jimenez,Midfielder,657,0,0,0,0,0
4264,Adam Henley,Henley,Defender,471,0,0,0,0,0
4299,Zdenek Grygera,Grygera,Defender,404,0,0,0,0,0
4297,Denis Stracqualursi,Stracqualursi,Forward,734,0,0,0,0,0
4006,Nathaniel Mendez-Laing,Mendez-Laing,Midfielder,986,0,0,0,0,0
4007,Sam Vokes,Vokes,Forward,4642,0,0,0,0,0
4291,Patrick Bamford,Bamford,Forward,4291,0,0,0,0,0
4008,Chris Iwelumo,Iwelumo,Forward,414,0,0,0,0,0
4289,Lucas Piazón,Piazon,Midfielder,16,0,0,0,0,0
4286,Oriol Romeu,Romeu,Midfielder,17426,0,0,0,0,0
4281,Marvin Sordell,Sordell,Forward,320,0,0,0,0,0
4278,Joe Riley,Riley,Defender,200,0,0,0,0,0
4017,Fernando Guerrero,Guerrero,Midfielder,72,0,0,0,0,0
4272,David Goodwillie,Goodwillie,Forward,596,0,0,0,0,0
4020,Landon Donovan,Donovan,Midfielder,1279,0,0,0,0,0
4270,Jordan Slew,Slew,Forward,1,0,0,0,0,0
4269,Simon Vukcevic,Vukcevic,Midfielder,377,0,0,0,0,0
4268,Marcus Olsson,Olsson,Defender,991,0,0,0,0,0
4267,Radosav Petrovic,Petrovic,Midfielder,978,0,0,0,0,0
4062,Mark Halstead,Halstead,Goalkeeper,24,0,0,0,0,0
4201,George Thorne,Thorne,Midfielder,362,0,0,0,0,0
4482,Chuba Akpom,Akpom,Forward,28,0,0,0,0,0
4145,David Silva,Silva,Midfielder,23975,0,0,0,0,0
4159,Ravel Morrison,Morrison,Midfielder,1199,0,0,0,0,0
4105,Nathaniel Chalobah,Chalobah,Midfielder,1865,0,0,0,0,0
4154,Anders Lindegaard,Lindegaard,Goalkeeper,1710,0,0,0,0,0
4153,John Guidetti,Guidetti,Forward,60,0,0,0,0,0
4110,Ján Mucha,Mucha,Goalkeeper,180,0,0,0,0,0
4151,Edin Dzeko,Dzeko,Forward,7081,0,0,0,0,0
4150,Abdul Razak,Razak,Midfielder,13,0,0,0,0,0
4116,Jermaine Beckford,Beckford,Forward,1388,0,0,0,0,0
4144,Reece Wabara,Wabara,Defender,2,0,0,0,0,0
4200,Somen Tchoyi,Tchoyi,Midfielder,1460,0,0,0,0,0
4142,Jérôme Boateng,Boateng,Defender,1239,0,0,0,0,0
4117,Magaye Gueye,Gueye,Forward,768,0,0,0,0,0
4139,Milan Jovanovic,Jovanovic,Forward,461,0,0,0,0,0
4118,Apostolos Vellios,Vellios,Forward,331,0,0,0,0,0
4137,Tom Ince,Ince,Midfielder,3164,0,0,0,0,0
4120,Neil Etheridge,Etheridge,Goalkeeper,3420,0,0,0,0,0
4121,Carlos Salcido,Salcido,Defender,1904,0,0,0,0,0
4122,Rafik Halliche,Halliche,Defender,14,0,0,0,0,0
4161,Chicharito,Chicharito,Forward,7804,0,0,0,0,0
4162,Bebé,Bebe,Forward,75,0,0,0,0,0
4163,Will Keane,Keane,Forward,290,0,0,0,0,0
4104,Josh McEachran,McEachran,Midfielder,309,0,0,0,0,0
4069,David Carney,Carney,Midfielder,490,0,0,0,0,0
4076,Elliot Grandin,Grandin,Midfielder,1515,0,0,0,0,0
4078,Ludovic Sylvestre,Sylvestre,Midfielder,429,0,0,0,0,0
4082,Ishmel Demontagnac,Demontagnac,Midfielder,33,0,0,0,0,0
4086,Gary Taylor-Fletcher,Taylor-Fletcher,Forward,2476,0,0,0,0,0
4189,Craig Lynch,Lynch,Forward,28,0,0,0,0,0
4188,Asamoah Gyan,Gyan,Forward,2232,0,0,0,0,0
4186,Billy Knott,Knott,Midfielder,16,0,0,0,0,0
4184,Cristian Riveros,Riveros,Midfielder,497,0,0,0,0,0
4090,Sergei Kornilenko,Kornilenko,Forward,179,0,0,0,0,0
4182,Louis Laing,Laing,Defender,2,0,0,0,0,0
4180,Marcos Angeleri,Angeleri,Defender,5,0,0,0,0,0
4094,Josh Vela,Vela,Midfielder,38,0,0,0,0,0
4176,Sammy Ameobi,Ameobi,Forward,2212,0,0,0,0,0
4101,Tomas Kalas,Kalas,Defender,180,0,0,0,0,0
4168,James Tavernier,Tavernier,Defender,37,0,0,0,0,0
4167,Shane Ferguson,Ferguson,Midfielder,805,0,0,0,0,0
4302,Pajtim Kasami,Kasami,Midfielder,2093,0,0,0,0,0
4303,Marcel Gecov,Gecov,Midfielder,6,0,0,0,0,0
4304,Mahamadou Diarra,Diarra,Midfielder,1699,0,0,0,0,0
3931,James Hurst,Hurst,Defender,90,0,0,0,0,0
3911,Abdisalam Abdulkadir Ibrahim,Ibrahim,Midfielder,14,0,0,0,0,0
3913,Alex Nimely,Nimely,Forward,7,0,0,0,0,0
4415,Mark Gower,Gower,Midfielder,1133,0,0,0,0,0
3919,Gabriel Obertan,Obertan,Midfielder,3377,0,0,0,0,0
3921,Magnus Wolff Eikrem,Eikrem,Midfielder,198,0,0,0,0,0
4412,Andrea Orlandi,Orlandi,Midfielder,118,0,0,0,0,0
3923,Ryan Tunnicliffe,Tunnicliffe,Midfielder,166,0,0,0,0,0
4404,Federico Bessone,Bessone,Defender,4,0,0,0,0,0
3932,Lennard Sowah,Sowah,Defender,340,0,0,0,0,0
4305,Kerim Frei,Frei,Midfielder,904,0,0,0,0,0
4397,Ji Dong-Won,Dong-Won,Forward,636,0,0,0,0,0
3936,Hassan Yebda,Yebda,Midfielder,1277,0,0,0,0,0
3940,Aruna Dindane,Dindane,Forward,1478,0,0,0,0,0
3947,Louis Moult,Moult,Forward,5,0,0,0,0,0
4385,Patrick Agyemang,Agyemang,Forward,148,0,0,0,0,0
4382,Ákos Buzsáky,Buzsaky,Midfielder,896,0,0,0,0,0
4381,Jamie Mackie,Mackie,Forward,3886,0,0,0,0,0
4380,Bruno Andrade,Andrade,Forward,10,0,0,0,0,0
4422,Stephen Dobbie,Dobbie,Forward,322,0,0,0,0,0
4426,Kevin Stewart,Stewart,Midfielder,582,0,0,0,0,0
4429,Iago Falque,Falque,Forward,5,0,0,0,0,0
4433,Alex Pritchard,Pritchard,Midfielder,3165,0,0,0,0,0
3898,Mark Cullen,Cullen,Forward,194,0,0,0,0,0
4480,Lukas Podolski,Podolski,Forward,3270,0,0,0,0,0
4478,Serge Gnabry,Gnabry,Forward,484,0,0,0,0,0
96,Ian Pearce,Pearce,Defender,32,0,0,0,0,0
3899,Jan Vennegoor of Hesselink,Hesselink,Forward,1490,0,0,0,0,0
4470,Shaun MacDonald,MacDonald,Midfielder,29,0,0,0,0,0
4469,Vangelis Moras,Moras,Defender,4,0,0,0,0,0
4468,Kaspars Gorkss,Gorkss,Defender,1260,0,0,0,0,0
4455,Johnny Gorman,Gorman,Midfielder,1,0,0,0,0,0
3903,Maxi Rodríguez,Rodriguez,Midfielder,4050,0,0,0,0,0
4451,Anthony Forde,Forde,Midfielder,242,0,0,0,0,0
4449,Dorus de Vries,Vries,Goalkeeper,322,0,0,0,0,0
4445,Albert Crusat,Crusat,Midfielder,486,0,0,0,0,0
4439,Liam O'Neil,O'Neil,Midfielder,15,0,0,0,0,0
3904,Alberto Aquilani,Aquilani,Midfielder,815,0,0,0,0,0
3906,Greg Cunningham,Cunningham,Defender,632,0,0,0,0,0
4436,Cameron Lancaster,Lancaster,Forward,11,0,0,0,0,0
4378,Michael Doughty,Doughty,Midfielder,51,0,0,0,0,0
4375,Taye Ismaila Taiwo,Taiwo,Defender,1194,0,0,0,0,0
4373,Michael Harriman,Harriman,Defender,118,0,0,0,0,0
4337,Jesse Lingard,Lingard,Midfielder,9229,0,0,0,0,0
3983,Victor Moses,Moses,Midfielder,13392,0,0,0,0,0
4334,Tom Thorpe,Thorpe,Defender,1,0,0,0,0,0
3984,Jason Scotland,Scotland,Forward,1549,0,0,0,0,0
3985,Marcelo Moreno Martins,Martins,Forward,727,0,0,0,0,0
3987,George Elokobi,Elokobi,Defender,4052,0,0,0,0,0
3992,Matt Hill,Hill,Defender,180,0,0,0,0,0
4325,Denis Suárez,Suarez,Midfielder,67,0,0,0,0,0
4322,Karim Rekik,Rekik,Defender,84,0,0,0,0,0
3996,David Edwards,Edwards,Midfielder,4216,0,0,0,0,0
3998,David Davis,Davis,Midfielder,399,0,0,0,0,0
4317,João Teixeira,Teixeira,Midfielder,11,0,0,0,0,0
4315,Suso,Suso,Midfielder,602,0,0,0,0,0
4002,Geoffrey Mujangi Bia,Bia,Midfielder,70,0,0,0,0,0
4310,Muamer Tankovic,Tankovic,Forward,59,0,0,0,0,0
4309,Marcello Trotta,Trotta,Forward,2,0,0,0,0,0
4308,Bryan Ruiz,Ruiz,Midfielder,4668,0,0,0,0,0
4307,Orlando Sá,Sa,Forward,281,0,0,0,0,0
4336,Larnell Cole,Cole,Midfielder,10,0,0,0,0,0
3977,Román Golobart,Golobart,Defender,213,0,0,0,0,0
4372,Bruno Perone,Perone,Defender,90,0,0,0,0,0
4342,Sylvain Marveaux,Marveaux,Midfielder,1351,0,0,0,0,0
3954,Ryan Noble,Noble,Forward,66,0,0,0,0,0
4367,Chris Martin,Martin,Forward,242,0,0,0,0,0
4366,Aaron Wilbraham,Wilbraham,Forward,388,0,0,0,0,0
4364,Simeon Jackson,Jackson,Forward,1342,0,0,0,0,0
4358,Simon Lappin,Lappin,Midfielder,291,0,0,0,0,0
3963,Fabio Daprelà,Daprela,Defender,372,0,0,0,0,0
4356,Anthony Pilkington,Pilkington,Midfielder,4957,0,0,0,0,0
4355,Jonny Howson,Howson,Midfielder,8028,0,0,0,0,0
4354,Andrew Crofts,Crofts,Midfielder,1288,0,0,0,0,0
3969,Ilan Araujo,Araujo,Forward,575,0,0,0,0,0
3970,Guillermo Franco,Franco,Forward,1371,0,0,0,0,0
4350,Marc Tierney,Tierney,Defender,1620,0,0,0,0,0
3971,Frank Nouble,Nouble,Forward,257,0,0,0,0,0
4348,Jed Steer,Steer,Goalkeeper,188,0,0,0,0,0
3972,Alessandro Diamanti,Diamanti,Forward,1900,0,0,0,0,0
4346,Papiss Demba Cissé,Cisse,Forward,7723,0,0,0,0,0
4343,Mehdi Abeid,Abeid,Midfielder,662,0,0,0,0,0
4803,Jesús Navas,Navas,Defender,7359,0,0,0,0,0
4805,Álvaro Negredo,Negredo,Forward,4602,0,0,0,0,0
10467,Angeliño,Angelino,Defender,422,0,0,0,0,0
8055,Lewis Grabban,Grabban,Forward,877,0,0,0,0,0
3281,Carlos Tevez,Tevez,Forward,12953,0,0,0,0,0
3286,Denny Landzaat,Landzaat,Midfielder,1585,0,0,0,0,0
3291,Julius Aghahowa,Aghahowa,Forward,415,0,0,0,0,0
3292,David Cotterill,Cotterill,Midfielder,100,0,0,0,0,0
3317,Craig Eastmond,Eastmond,Midfielder,170,0,0,0,0,0
8107,Oliver McBurnie,McBurnie,Forward,3781,0,0,0,0,0
8058,Tokelo Rantie,Rantie,Forward,38,0,0,0,0,0
8057,Yann Kermorgant,Kermorgant,Forward,125,0,0,0,0,0
3320,Luke Freeman,Freeman,Midfielder,362,0,0,0,0,0
7744,Ola Toivonen,Toivonen,Forward,663,0,0,0,0,0
8049,Marc Pugh,Pugh,Midfielder,3647,0,0,0,0,0
3326,Moustapha Salifou,Salifou,Midfielder,43,0,0,0,0,0
3330,Rafael Schmitz,Schmitz,Defender,1075,0,0,0,0,0
3333,Jordon Mutch,Mutch,Midfielder,4204,0,0,0,0,0
7990,Jordan Rhodes,Rhodes,Forward,208,0,0,0,0,0
3334,Daniel de Ridder,Ridder,Midfielder,1151,0,0,0,0,0
3335,Olivier Kapo,Kapo,Midfielder,2938,0,0,0,0,0
3336,Borja Oubiña,Oubina,Midfielder,17,0,0,0,0,0
8174,Leonardo Ulloa,Ulloa,Forward,4091,0,0,0,0,0
8175,William Buckley,Buckley,Midfielder,868,0,0,0,0,0
3270,Marlon King,King,Forward,3158,0,0,0,0,0
8192,Bobby De Cordova-Reid,Cordova-Reid,Forward,3804,0,0,0,0,0
8709,William Kvist,Kvist,Midfielder,592,0,0,0,0,0
3194,Scott Golbourne,Golbourne,Defender,63,0,0,0,0,0
3197,Bobby Convey,Convey,Midfielder,1055,0,0,0,0,0
3204,Leroy Lita,Lita,Forward,1386,0,0,0,0,0
8650,Matt Grimes,Grimes,Midfielder,132,0,0,0,0,0
8598,James Husband,Husband,Defender,59,0,0,0,0,0
3206,Shane Long,Long,Forward,16998,0,0,0,0,0
8578,Max Lowe,Lowe,Defender,551,0,0,0,0,0
8454,Callum Wilson,Wilson,Forward,13038,0,0,0,0,0
8444,John Fleck,Fleck,Midfielder,5094,0,0,0,0,0
8356,Diego Poyet,Poyet,Midfielder,90,0,0,0,0,0
8335,Gary Madine,Madine,Forward,32,0,0,0,0,0
8318,Jo Inge Berget,Berget,Midfielder,11,0,0,0,0,0
8317,Mats Møller Dæhli,Daehli,Midfielder,626,0,0,0,0,0
8293,Will Norris,Norris,Goalkeeper,181,0,0,0,0,0
3223,Michael Tonge,Tonge,Midfielder,292,0,0,0,0,0
8232,Daniel Lafferty,Lafferty,Defender,16,0,0,0,0,0
3337,Garry O'Connor,O'Connor,Forward,1473,0,0,0,0,0
7628,Lacina Emeghara Traoré,Traore,Forward,1,0,0,0,0,0
6393,Dieumerci Mbokani,Mbokani,Forward,2351,0,0,0,0,0
3372,Miles Addison,Addison,Defender,90,0,0,0,0,0
3367,Claudio Pizarro,Pizarro,Forward,681,0,0,0,0,0
7081,Lucas Pérez,Perez,Forward,731,0,0,0,0,0
3370,Lewis Price,Price,Goalkeeper,540,0,0,0,0,0
6903,Clinton N'Jie,N'Jie,Forward,184,0,0,0,0,0
6900,Bafétimbi Gomis,Gomis,Forward,3334,0,0,0,0,0
6899,Alexandre Lacazette,Lacazette,Forward,10309,0,0,0,0,0
6889,Rachid Ghezzal,Ghezzal,Midfielder,735,0,0,0,0,0
6820,Ondrej Duda,Duda,Midfielder,729,0,0,0,0,0
3373,Mohammed Camara,Camara,Midfielder,63,0,0,0,0,0
7568,Carles Gil,Gil,Midfielder,1799,0,0,0,0,0
3374,Lewin Nyatanga,Nyatanga,Defender,180,0,0,0,0,0
6627,Kenneth Zohore,Zohore,Forward,746,0,0,0,0,0
6615,Juan Cuadrado,Cuadrado,Defender,337,0,0,0,0,0
3377,Stephen Pearson,Pearson,Midfielder,1995,0,0,0,0,0
3378,Mile Sterjovski,Sterjovski,Midfielder,692,0,0,0,0,0
3379,Benny Feilhaber,Feilhaber,Midfielder,293,0,0,0,0,0
6494,Evandro,Evandro,Midfielder,576,0,0,0,0,0
3380,Emanuel Villa,Villa,Forward,915,0,0,0,0,0
7105,Jetro Willems,Willems,Defender,1498,0,0,0,0,0
3366,Franco Di Santo,Santo,Forward,6397,0,0,0,0,0
3358,Shaun Cummings,Cummings,Defender,810,0,0,0,0,0
7122,Luciano Narsingh,Narsingh,Forward,1027,0,0,0,0,0
3338,Mauro Zárate,Zarate,Forward,2084,0,0,0,0,0
3341,Gunnar Nielsen,Nielsen,Goalkeeper,14,0,0,0,0,0
3343,Johann Vogel,Vogel,Midfielder,473,0,0,0,0,0
7490,Josh Onomah,Onomah,Midfielder,468,0,0,0,0,0
7488,Harry Winks,Winks,Midfielder,6836,0,0,0,0,0
7486,Milos Veljkovic,Veljkovic,Defender,30,0,0,0,0,0
7482,Jay Fulton,Fulton,Midfielder,923,0,0,0,0,0
3346,Roque Santa Cruz,Cruz,Forward,5880,0,0,0,0,0
7431,Ibrahima Cissé,Cisse,Midfielder,87,0,0,0,0,0
3347,Maceo Rigters,Rigters,Forward,14,0,0,0,0,0
7234,Vicente Iborra,Iborra,Midfielder,1641,0,0,0,0,0
3351,Mikel Alonso,Alonso,Midfielder,357,0,0,0,0,0
3352,Christian Wilhelmsson,Wilhelmsson,Midfielder,232,0,0,0,0,0
3356,Daniel Braaten,Braaten,Forward,143,0,0,0,0,0
7175,Giedrius Arlauskis,Arlauskis,Goalkeeper,23,0,0,0,0,0
7163,Dani Ceballos,Ceballos,Midfielder,3314,0,0,0,0,0
7124,Jürgen Locadia,Locadia,Forward,1560,0,0,0,0,0
8710,Patrick Roberts,Roberts,Midfielder,72,0,0,0,0,0
8712,Moussa Dembele,Dembele,Forward,88,0,0,0,0,0
8868,Jarrod Bowen,Bowen,Forward,6660,0,0,0,0,0
9985,Marco Borriello,Borriello,Forward,90,0,0,0,0,0
10394,Bertrand Traoré,Traore,Forward,2919,0,0,0,0,0
10380,Joseph Dodoo,Dodoo,Forward,19,0,0,0,0,0
10336,Duncan Watmore,Watmore,Forward,1935,0,0,0,0,0
10191,Sullay Kaikai,Kaikai,Forward,81,0,0,0,0,0
3065,John Carew,Carew,Forward,7639,0,0,0,0,0
3066,Shaun Maloney,Maloney,Midfielder,4984,0,0,0,0,0
10004,Bakary Sako,Sako,Midfielder,1704,0,0,0,0,0
3071,Bruno Berner,Berner,Defender,180,0,0,0,0,0
9982,Reece Burke,Burke,Defender,415,0,0,0,0,0
3187,Alex Pearce,Pearce,Defender,1645,0,0,0,0,0
9980,Thievy Bifouma,Bifouma,Forward,252,0,0,0,0,0
3076,Keith Treacy,Treacy,Midfielder,296,0,0,0,0,0
9950,Ikechi Anya,Anya,Midfielder,1689,0,0,0,0,0
3087,Andranik Teymourian,Teymourian,Midfielder,85,0,0,0,0,0
9869,Baily Cargill,Cargill,Defender,12,0,0,0,0,0
9794,Ignacio Scocco,Scocco,Forward,93,0,0,0,0,0
3099,Sam Hutchinson,Hutchinson,Midfielder,98,0,0,0,0,0
4125,Cauley Woodrow,Woodrow,Forward,411,0,0,0,0,0
3064,Isaiah Osbourne,Osbourne,Midfielder,162,0,0,0,0,0
3063,Stiliyan Petrov,Petrov,Midfielder,12690,0,0,0,0,0
3057,Jay Simpson,Simpson,Forward,706,0,0,0,0,0
3056,Mark Randall,Randall,Midfielder,17,0,0,0,0,0
3035,Josip Skoko,Skoko,Midfielder,666,0,0,0,0,0
10465,Divock Origi,Origi,Forward,3515,0,0,0,0,0
3037,David Connolly,Connolly,Forward,95,0,0,0,0,0
10461,Dame N'Doye,N'Doye,Forward,1762,0,0,0,0,0
10460,Abel Hernández,Hernandez,Forward,2740,0,0,0,0,0
3040,Stuart Holden,Holden,Midfielder,2410,0,0,0,0,0
10455,Kieran Dowell,Dowell,Midfielder,985,0,0,0,0,0
3041,Grzegorz Rasiak,Rasiak,Forward,278,0,0,0,0,0
3048,Gavin Hoyte,Hoyte,Defender,60,0,0,0,0,0
3049,Henri Lansbury,Lansbury,Midfielder,228,0,0,0,0,0
10443,Dominic Solanke,Solanke,Forward,2567,0,0,0,0,0
10441,Jérémie Boga,Boga,Forward,18,0,0,0,0,0
10439,Ola Aina,Aina,Defender,2694,0,0,0,0,0
10435,Fredrik Ulvestad,Ulvestad,Midfielder,67,0,0,0,0,0
10433,Andre Green,Green,Forward,57,0,0,0,0,0
10432,Rushian Marcus Amari Hepburn-Murphy,Hepburn-Murphy,Forward,8,0,0,0,0,0
3054,Fran Mérida,Merida,Midfielder,81,0,0,0,0,0
9649,Sam McQueen,McQueen,Midfielder,750,0,0,0,0,0
9634,Connor Goldson,Goldson,Defender,199,0,0,0,0,0
3106,Andriy Shevchenko,Shevchenko,Forward,744,0,0,0,0,0
9131,Albert Adomah,Adomah,Midfielder,121,0,0,0,0,0
3151,Michael Johnson,Johnson,Midfielder,2196,0,0,0,0,0
9060,Andre Gray,Gray,Forward,5869,0,0,0,0,0
9032,Cameron Brannagan,Brannagan,Midfielder,112,0,0,0,0,0
9031,Jordan Rossiter,Rossiter,Midfielder,14,0,0,0,0,0
3153,Emile Mpenza,Mpenza,Forward,742,0,0,0,0,0
8983,Riyad Mahrez,Mahrez,Forward,17651,0,0,0,0,0
3165,Seb Hines,Hines,Defender,4,0,0,0,0,0
3166,Herold Goulon,Goulon,Midfielder,57,0,0,0,0,0
3167,Lee Dong-Gook,Dong-Gook,Forward,549,0,0,0,0,0
3173,Kazenga LuaLua,LuaLua,Midfielder,88,0,0,0,0,0
8970,Marcin Wasilewski,Wasilewski,Defender,2381,0,0,0,0,0
8968,Liam Moore,Moore,Defender,936,0,0,0,0,0
3176,Obafemi Martins,Martins,Forward,4100,0,0,0,0,0
3179,Arnold Mvuemba,Mvuemba,Midfielder,452,0,0,0,0,0
8935,Freddie Ladapo,Ladapo,Forward,16,0,0,0,0,0
3180,Niko Kranjcar,Kranjcar,Midfielder,8545,0,0,0,0,0
8889,Nahki Wells,Wells,Forward,46,0,0,0,0,0
3149,Kelvin Etuhu,Etuhu,Midfielder,394,0,0,0,0,0
9134,Lee Tomlin,Tomlin,Forward,289,0,0,0,0,0
9581,Jamie Murphy,Murphy,Forward,166,0,0,0,0,0
3142,Andreas Isaksson,Isaksson,Goalkeeper,450,0,0,0,0,0
9567,Kieron Freeman,Freeman,Defender,6,0,0,0,0,0
3111,Manuel Fernandes,Fernandes,Midfielder,846,0,0,0,0,0
3116,Matthew Briggs,Briggs,Defender,670,0,0,0,0,0
9473,Danny Williams,Williams,Midfielder,1211,0,0,0,0,0
3125,Emiliano Insúa,Insua,Defender,3773,0,0,0,0,0
9457,Josh Brownhill,Brownhill,Midfielder,6573,0,0,0,0,0
3129,Stephen Darby,Darby,Defender,1,0,0,0,0,0
9417,Jordan Hugill,Hugill,Forward,22,0,0,0,0,0
9377,Conor Hourihane,Hourihane,Midfielder,1765,0,0,0,0,0
9293,Joel Coleman,Coleman,Goalkeeper,90,0,0,0,0,0
9266,Ben Osborn,Osborn,Midfielder,2197,0,0,0,0,0
3132,Nabil El Zhar,Zhar,Midfielder,322,0,0,0,0,0
3134,Adam Hammill,Hammill,Midfielder,889,0,0,0,0,0
9246,Ivan Toney,Toney,Forward,2918,0,0,0,0,0
9199,Adam Armstrong,Armstrong,Forward,1646,0,0,0,0,0
9198,Luuk de Jong,Jong,Forward,671,0,0,0,0,0
3138,Lee Peltier,Peltier,Defender,1771,0,0,0,0,0
6425,Joselu,Joselu,Forward,3393,0,0,0,0,0
6390,Brown Ideye,Ideye,Forward,1296,0,0,0,0,0
4806,Stevan Jovetic,Jovetic,Forward,1147,0,0,0,0,0
4915,Filipe Luís,Luis,Defender,939,0,0,0,0,0
3566,Nathan Delfouneso,Delfouneso,Forward,867,0,0,0,0,0
4955,Martín Montoya,Montoya,Defender,4066,0,0,0,0,0
3572,Carlos Villanueva,Villanueva,Midfielder,645,0,0,0,0,0
3577,Aaron Doran,Doran,Forward,117,0,0,0,0,0
4931,Saúl Ñíguez,Niguez,Midfielder,478,0,0,0,0,0
4925,Mario Suárez,Suarez,Midfielder,744,0,0,0,0,0
3578,Nick Blackman,Blackman,Forward,395,0,0,0,0,0
3580,Sébastien Puygrenier,Puygrenier,Defender,380,0,0,0,0,0
3582,Ebi Smolarek,Smolarek,Midfielder,213,0,0,0,0,0
3585,Ariza Makukula,Makukula,Forward,293,0,0,0,0,0
3583,Johan Elmander,Elmander,Forward,8325,0,0,0,0,0
4908,Kim Källström,Kallstrom,Midfielder,128,0,0,0,0,0
4898,Bojan,Bojan,Forward,3465,0,0,0,0,0
4896,Viktor Fischer,Fischer,Forward,438,0,0,0,0,0
4888,Daley Blind,Blind,Defender,7478,0,0,0,0,0
4886,Davy Klaassen,Klaassen,Midfielder,250,0,0,0,0,0
4885,Siem de Jong,Jong,Midfielder,593,0,0,0,0,0
3584,Mustapha Riga,Riga,Forward,455,0,0,0,0,0
4973,Alexis Sánchez,Sanchez,Forward,12048,0,0,0,0,0
3554,Jay Emmanuel-Thomas,Emmanuel-Thomas,Forward,9,0,0,0,0,0
3552,Amaury Bischoff,Bischoff,Midfielder,25,0,0,0,0,0
4988,Konstantinos Stafylidis,Stafylidis,Defender,334,0,0,0,0,0
5169,Teemu Pukki,Pukki,Forward,6152,0,0,0,0,0
3505,David Button,Button,Goalkeeper,450,0,0,0,0,0
5154,Stefan Johansen,Johansen,Midfielder,411,0,0,0,0,0
3509,Gilberto,Gilberto,Defender,385,0,0,0,0,0
5137,Adam Matthews,Matthews,Defender,36,0,0,0,0,0
3514,Kevin-Prince Boateng,Boateng,Forward,2444,0,0,0,0,0
3515,Simon Dawkins,Dawkins,Midfielder,71,0,0,0,0,0
5097,Erik Durm,Durm,Defender,2052,0,0,0,0,0
3520,Jack Collison,Collison,Midfielder,4526,0,0,0,0,0
3521,Freddie Sears,Sears,Forward,1423,0,0,0,0,0
5078,Lazar Markovic,Markovic,Midfielder,1988,0,0,0,0,0
5074,Nélson Oliveira,Oliveira,Forward,389,0,0,0,0,0
3526,Erik Hagen,Hagen,Defender,74,0,0,0,0,0
3536,Steve Howard,Howard,Forward,1392,0,0,0,0,0
3538,Ben Hutchinson,Hutchinson,Forward,183,0,0,0,0,0
5057,Filip Djuricic,Djuricic,Midfielder,327,0,0,0,0,0
3550,Andrey Arshavin,Arshavin,Midfielder,6258,0,0,0,0,0
4878,Jairo Riedewald,Riedewald,Midfielder,3132,0,0,0,0,0
3586,Temitope Obadeyi,Obadeyi,Forward,41,0,0,0,0,0
6389,Andriy Yarmolenko,Yarmolenko,Forward,2115,0,0,0,0,0
3630,Ryan France,France,Midfielder,93,0,0,0,0,0
3612,Fredrik Stoor,Stoor,Defender,77,0,0,0,0,0
4831,Charalampos Mavrias,Mavrias,Midfielder,150,0,0,0,0,0
4830,Emanuele Giaccherini,Giaccherini,Midfielder,1659,0,0,0,0,0
4829,El-Hadji Ba,Ba,Midfielder,19,0,0,0,0,0
4828,Cabral,Cabral,Midfielder,90,0,0,0,0,0
3628,Nathan Doyle,Doyle,Midfielder,213,0,0,0,0,0
4826,Modibo Diakité,Diakite,Defender,630,0,0,0,0,0
4825,Ondrej Celustka,Celustka,Defender,1331,0,0,0,0,0
4822,Muniesa,Muniesa,Defender,3973,0,0,0,0,0
4865,Jamar Loza,Loza,Forward,32,0,0,0,0,0
3631,Péter Halmosi,Halmosi,Midfielder,545,0,0,0,0,0
4819,Daniel Osvaldo,Osvaldo,Forward,855,0,0,0,0,0
4818,Harrison Reed,Reed,Midfielder,2793,0,0,0,0,0
3632,Will Atkinson,Atkinson,Midfielder,180,0,0,0,0,0
3635,Daniel Cousin,Cousin,Forward,1661,0,0,0,0,0
4814,Jason McCarthy,McCarthy,Defender,3,0,0,0,0,0
4811,Ricky van Wolfswinkel,Wolfswinkel,Forward,1394,0,0,0,0,0
4809,Guillermo Varela,Varela,Defender,315,0,0,0,0,0
4836,José Cañas,Canas,Midfielder,1670,0,0,0,0,0
4837,Alejandro Pozuelo,Pozuelo,Midfielder,868,0,0,0,0,0
3608,Jose Baxter,Baxter,Forward,116,0,0,0,0,0
4839,Álvaro Vázquez,Vazquez,Forward,410,0,0,0,0,0
3591,Ricardo Quaresma,Quaresma,Midfielder,130,0,0,0,0,0
4863,Matty Fryatt,Fryatt,Forward,219,0,0,0,0,0
4859,Christian Atsu,Atsu,Midfielder,4120,0,0,0,0,0
4857,Kevin McNaughton,McNaughton,Defender,281,0,0,0,0,0
4856,Kadeem Harris,Harris,Midfielder,366,0,0,0,0,0
4853,Razvan Rat,Rat,Defender,1131,0,0,0,0,0
3592,Deco,Deco,Midfielder,2785,0,0,0,0,0
4851,Matej Vydra,Vydra,Midfielder,3826,0,0,0,0,0
3593,Mineiro,Mineiro,Midfielder,15,0,0,0,0,0
3594,Gaël Kakuta,Kakuta,Midfielder,449,0,0,0,0,0
3595,Miroslav Stoch,Stoch,Midfielder,22,0,0,0,0,0
4846,Roberto Soldado,Soldado,Forward,2725,0,0,0,0,0
3597,Gökhan Töre,Tore,Midfielder,239,0,0,0,0,0
4844,Nacer Chadli,Chadli,Midfielder,7169,0,0,0,0,0
3599,Lars Jacobsen,Jacobsen,Defender,3391,0,0,0,0,0
3606,Jô,Jo,Forward,2376,0,0,0,0,0
3607,Kieran Agard,Agard,Forward,1,0,0,0,0,0
3502,Rade Prica,Prica,Forward,206,0,0,0,0,0
3500,Martyn Waghorn,Waghorn,Forward,156,0,0,0,0,0
5179,Ruben Loftus-Cheek,Loftus-Cheek,Midfielder,6995,0,0,0,0,0
3430,Ryan McGivern,McGivern,Defender,20,0,0,0,0,0
5804,Álvaro Morata,Morata,Forward,3010,0,0,0,0,0
5803,Jesé,Jese,Forward,616,0,0,0,0,0
3429,Sam Williamson,Williamson,Defender,36,0,0,0,0,0
5790,Diego Llorente,Llorente,Defender,3548,0,0,0,0,0
5782,Raphaël Varane,Varane,Defender,1829,0,0,0,0,0
5772,Zlatan Ibrahimovic,Ibrahimovic,Forward,2539,0,0,0,0,0
5771,Edinson Cavani,Cavani,Forward,2132,0,0,0,0,0
5762,Lucas Moura,Moura,Forward,7757,0,0,0,0,0
3434,Elano,Elano,Midfielder,4334,0,0,0,0,0
5180,John Swift,Swift,Midfielder,1,0,0,0,0,0
5698,Gonzalo Higuaín,Higuain,Forward,1092,0,0,0,0,0
3438,Valeri Emilov Bozhinov,Bozhinov,Forward,270,0,0,0,0,0
5691,Gökhan Inler,Inler,Midfielder,194,0,0,0,0,0
3439,Rolando Bianchi,Bianchi,Forward,761,0,0,0,0,0
3440,Felipe Caicedo,Caicedo,Forward,1030,0,0,0,0,0
3441,Ched Evans,Evans,Forward,400,0,0,0,0,0
5671,Juan Camilo Zuñiga,Zuniga,Defender,813,0,0,0,0,0
3442,Nery Castillo,Castillo,Forward,293,0,0,0,0,0
5806,Willian José,Jose,Forward,1113,0,0,0,0,0
3428,Shaleum Logan,Logan,Defender,90,0,0,0,0,0
3422,Dani Pacheco,Pacheco,Midfielder,44,0,0,0,0,0
3421,Andrey Voronin,Voronin,Forward,1320,0,0,0,0,0
3381,Giles Barnes,Barnes,Forward,1686,0,0,0,0,0
6362,Aleksandar Dragovic,Dragovic,Defender,767,0,0,0,0,0
6292,Ivo Pinto,Pinto,Defender,811,0,0,0,0,0
3382,Paris Simmons,Simmons,Forward,26,0,0,0,0,0
6215,Steven Berghuis,Berghuis,Forward,222,0,0,0,0,0
3383,Stefan Wessels,Wessels,Goalkeeper,180,0,0,0,0,0
6204,Markus Henriksen,Henriksen,Midfielder,633,0,0,0,0,0
3392,Lukas Jutkiewicz,Jutkiewicz,Forward,990,0,0,0,0,0
6077,Kostas Mitroglou,Mitroglou,Forward,151,0,0,0,0,0
3396,Toni Kallio,Kallio,Defender,221,0,0,0,0,0
3398,Wayne Brown,Brown,Midfielder,4,0,0,0,0,0
5937,Florin Gardos,Gardos,Defender,574,0,0,0,0,0
5907,Bernard,Bernard,Forward,3854,0,0,0,0,0
3399,Eddie Johnson,Johnson,Forward,617,0,0,0,0,0
3408,Alexander Kacaniklic,Kacaniklic,Midfielder,2762,0,0,0,0,0
3411,Damien Plessis,Plessis,Midfielder,225,0,0,0,0,0
3413,Ryan Babel,Babel,Midfielder,4656,0,0,0,0,0
5665,Anthony Réveillere,Reveillere,Defender,1327,0,0,0,0,0
5650,M'Baye Niang,Niang,Forward,1254,0,0,0,0,0
5632,Antonio Nocerino,Nocerino,Midfielder,254,0,0,0,0,0
5377,Max Meyer,Meyer,Midfielder,2060,0,0,0,0,0
3473,John Utaka,Utaka,Forward,3768,0,0,0,0,0
3481,Jem Karacan,Karacan,Midfielder,1606,0,0,0,0,0
5361,Ralf Fährmann,Fahrmann,Goalkeeper,22,0,0,0,0,0
5354,Silvestre Varela,Varela,Forward,333,0,0,0,0,0
5349,Juan Iturbe,Iturbe,Forward,55,0,0,0,0,0
5345,Steven Defour,Defour,Midfielder,3538,0,0,0,0,0
3483,Jimmy Kébé,Kebe,Midfielder,1669,0,0,0,0,0
3485,Emerse Faé,Fae,Midfielder,293,0,0,0,0,0
5328,Danilo,Danilo,Defender,2147,0,0,0,0,0
5271,Bastian Schweinsteiger,Schweinsteiger,Midfielder,1202,0,0,0,0,0
5267,Xherdan Shaqiri,Shaqiri,Midfielder,8577,0,0,0,0,0
3497,Carlos Edwards,Edwards,Midfielder,1625,0,0,0,0,0
5248,Albian Ajeti,Ajeti,Forward,132,0,0,0,0,0
3498,Ross Wallace,Wallace,Midfielder,1729,0,0,0,0,0
3499,Roy O'Donovan,O'Donovan,Forward,445,0,0,0,0,0
5211,Seydou Doumbia,Doumbia,Forward,29,0,0,0,0,0
5208,Ahmed Musa,Musa,Forward,753,0,0,0,0,0
3469,Lucien Aubey,Aubey,Defender,169,0,0,0,0,0
5384,Leroy Sané,Sane,Forward,6086,0,0,0,0,0
3445,Owen Hargreaves,Hargreaves,Midfielder,1665,0,0,0,0,0
5428,Markus Suttner,Suttner,Defender,1178,0,0,0,0,0
5594,André Ayew,Ayew,Forward,6220,0,0,0,0,0
3446,Anderson,Anderson,Midfielder,6172,0,0,0,0,0
3449,Rodrigo Possebon,Possebon,Midfielder,51,0,0,0,0,0
5585,Florian Thauvin,Thauvin,Midfielder,420,0,0,0,0,0
3453,Manucho,Manucho,Forward,665,0,0,0,0,0
3454,Federico Macheda,Macheda,Forward,609,0,0,0,0,0
5570,Nicolas Nkoulou,Nkoulou,Defender,168,0,0,0,0,0
3457,Jason Steele,Steele,Goalkeeper,90,0,0,0,0,0
5562,James Wilson,Wilson,Forward,420,0,0,0,0,0
5561,Tom Lawrence,Lawrence,Forward,121,0,0,0,0,0
5559,Bersant Celina,Celina,Midfielder,13,0,0,0,0,0
5548,Mbaye Diagne,Diagne,Forward,1194,0,0,0,0,0
3459,Mohamed Shawky,Shawky,Midfielder,1104,0,0,0,0,0
3460,Afonso Alves,Alves,Forward,2821,0,0,0,0,0
5513,Martín Cáceres,Caceres,Defender,90,0,0,0,0,0
3461,Tuncay Sanli,Sanli,Forward,7272,0,0,0,0,0
3464,Lamine Diatta,Diatta,Defender,8,0,0,0,0,0
122388,Chiquinho,Chiquinho,Forward,204,0,0,0,0,0
